filename,mask,xmin,ymin,xmax,ymax,xmax-xmin,ymax-ymin,height,width,height_check,width_check
maksssksksss0.png,without_mask,79,105,109,142,30,37,366,512,0,0
maksssksksss0.png,with_mask,185,100,226,144,41,44,366,512,0,0
maksssksksss0.png,without_mask,325,90,360,141,35,51,366,512,0,0
maksssksksss1.png,with_mask,321,34,354,69,33,35,156,400,0,0
maksssksksss1.png,with_mask,224,38,261,73,37,35,156,400,0,0
maksssksksss1.png,with_mask,299,58,315,81,16,23,156,400,0,0
maksssksksss1.png,with_mask,143,74,174,115,31,41,156,400,0,0
maksssksksss1.png,with_mask,74,69,95,99,21,30,156,400,0,0
maksssksksss1.png,with_mask,191,67,221,93,30,26,156,400,0,0
maksssksksss1.png,with_mask,21,73,44,93,23,20,156,400,0,0
maksssksksss1.png,with_mask,369,70,398,99,29,29,156,400,0,0
maksssksksss1.png,without_mask,83,56,111,89,28,33,156,400,0,0
maksssksksss10.png,with_mask,98,267,194,383,96,116,400,301,0,0
maksssksksss100.png,with_mask,189,30,245,88,56,58,226,400,0,0
maksssksksss100.png,with_mask,387,54,400,75,13,21,226,400,0,0
maksssksksss100.png,with_mask,118,87,163,126,45,39,226,400,0,0
maksssksksss101.png,with_mask,48,294,164,400,116,106,400,301,0,0
maksssksksss102.png,with_mask,212,57,251,106,39,49,225,400,0,0
maksssksksss103.png,with_mask,42,54,94,110,52,56,300,400,0,0
maksssksksss103.png,with_mask,188,46,236,106,48,60,300,400,0,0
maksssksksss103.png,with_mask,261,88,303,130,42,42,300,400,0,0
maksssksksss103.png,with_mask,368,112,400,151,32,39,300,400,0,0
maksssksksss104.png,without_mask,42,109,66,140,24,31,267,400,0,0
maksssksksss104.png,without_mask,2,105,22,125,20,20,267,400,0,0
maksssksksss104.png,without_mask,30,88,46,105,16,17,267,400,0,0
maksssksksss104.png,with_mask,133,108,174,152,41,44,267,400,0,0
maksssksksss104.png,with_mask,221,101,256,139,35,38,267,400,0,0
maksssksksss104.png,without_mask,304,131,331,158,27,27,267,400,0,0
maksssksksss104.png,without_mask,83,85,96,96,13,11,267,400,0,0
maksssksksss104.png,without_mask,167,91,180,108,13,17,267,400,0,0
maksssksksss105.png,with_mask,178,143,213,202,35,59,267,400,0,0
maksssksksss105.png,with_mask,280,103,312,145,32,42,267,400,0,0
maksssksksss105.png,with_mask,320,79,352,119,32,40,267,400,0,0
maksssksksss105.png,with_mask,365,53,390,84,25,31,267,400,0,0
maksssksksss105.png,with_mask,243,36,267,67,24,31,267,400,0,0
maksssksksss105.png,with_mask,115,47,146,87,31,40,267,400,0,0
maksssksksss105.png,with_mask,33,88,65,131,32,43,267,400,0,0
maksssksksss105.png,with_mask,29,202,65,265,36,63,267,400,0,0
maksssksksss105.png,with_mask,26,34,52,66,26,32,267,400,0,0
maksssksksss106.png,with_mask,154,51,423,391,269,340,399,600,0,0
maksssksksss107.png,with_mask,121,192,212,312,91,120,400,301,0,0
maksssksksss108.png,with_mask,155,29,180,51,25,22,225,400,0,0
maksssksksss108.png,with_mask,206,35,228,58,22,23,225,400,0,0
maksssksksss108.png,with_mask,332,67,346,81,14,14,225,400,0,0
maksssksksss108.png,with_mask,362,68,376,82,14,14,225,400,0,0
maksssksksss108.png,without_mask,267,72,278,83,11,11,225,400,0,0
maksssksksss109.png,with_mask,216,92,372,251,156,159,400,400,0,0
maksssksksss11.png,mask_weared_incorrect,23,114,77,172,54,58,267,400,0,0
maksssksksss11.png,with_mask,147,157,200,211,53,54,267,400,0,0
maksssksksss11.png,with_mask,201,191,230,234,29,43,267,400,0,0
maksssksksss11.png,with_mask,243,192,293,247,50,55,267,400,0,0
maksssksksss11.png,with_mask,309,182,346,224,37,42,267,400,0,0
maksssksksss11.png,with_mask,249,108,276,140,27,32,267,400,0,0
maksssksksss11.png,with_mask,275,99,303,128,28,29,267,400,0,0
maksssksksss11.png,with_mask,195,90,214,113,19,23,267,400,0,0
maksssksksss11.png,with_mask,214,76,237,99,23,23,267,400,0,0
maksssksksss11.png,with_mask,232,50,247,67,15,17,267,400,0,0
maksssksksss11.png,with_mask,266,45,281,61,15,16,267,400,0,0
maksssksksss11.png,with_mask,207,47,222,63,15,16,267,400,0,0
maksssksksss11.png,with_mask,227,36,239,48,12,12,267,400,0,0
maksssksksss11.png,with_mask,253,33,267,45,14,12,267,400,0,0
maksssksksss110.png,without_mask,6,111,43,148,37,37,267,400,0,0
maksssksksss110.png,without_mask,22,20,49,46,27,26,267,400,0,0
maksssksksss110.png,with_mask,48,12,70,37,22,25,267,400,0,0
maksssksksss110.png,with_mask,113,1,136,24,23,23,267,400,0,0
maksssksksss110.png,without_mask,78,17,106,46,28,29,267,400,0,0
maksssksksss110.png,without_mask,97,66,115,86,18,20,267,400,0,0
maksssksksss110.png,without_mask,70,111,104,145,34,34,267,400,0,0
maksssksksss110.png,without_mask,42,157,85,186,43,29,267,400,0,0
maksssksksss110.png,with_mask,59,205,111,264,52,59,267,400,0,0
maksssksksss110.png,without_mask,116,155,172,198,56,43,267,400,0,0
maksssksksss110.png,without_mask,112,85,149,118,37,33,267,400,0,0
maksssksksss110.png,without_mask,124,27,153,47,29,20,267,400,0,0
maksssksksss110.png,without_mask,163,29,189,53,26,24,267,400,0,0
maksssksksss110.png,with_mask,186,18,215,44,29,26,267,400,0,0
maksssksksss110.png,with_mask,178,77,214,111,36,34,267,400,0,0
maksssksksss110.png,without_mask,216,57,241,84,25,27,267,400,0,0
maksssksksss110.png,without_mask,237,15,268,46,31,31,267,400,0,0
maksssksksss110.png,without_mask,281,19,308,40,27,21,267,400,0,0
maksssksksss110.png,without_mask,286,60,311,84,25,24,267,400,0,0
maksssksksss110.png,with_mask,253,94,293,135,40,41,267,400,0,0
maksssksksss110.png,without_mask,236,161,273,195,37,34,267,400,0,0
maksssksksss110.png,with_mask,282,194,322,232,40,38,267,400,0,0
maksssksksss110.png,with_mask,314,115,350,152,36,37,267,400,0,0
maksssksksss110.png,without_mask,335,27,359,52,24,25,267,400,0,0
maksssksksss110.png,with_mask,356,72,385,98,29,26,267,400,0,0
maksssksksss111.png,with_mask,17,182,35,202,18,20,268,400,0,0
maksssksksss111.png,with_mask,48,98,61,113,13,15,268,400,0,0
maksssksksss111.png,with_mask,109,59,132,82,23,23,268,400,0,0
maksssksksss111.png,with_mask,140,64,161,85,21,21,268,400,0,0
maksssksksss111.png,with_mask,184,68,207,93,23,25,268,400,0,0
maksssksksss111.png,with_mask,248,73,267,95,19,22,268,400,0,0
maksssksksss111.png,with_mask,291,65,314,90,23,25,268,400,0,0
maksssksksss111.png,with_mask,383,96,397,110,14,14,268,400,0,0
maksssksksss111.png,without_mask,383,125,398,145,15,20,268,400,0,0
maksssksksss112.png,mask_weared_incorrect,90,84,138,131,48,47,400,267,0,0
maksssksksss113.png,with_mask,133,108,148,124,15,16,267,400,0,0
maksssksksss113.png,with_mask,203,117,214,131,11,14,267,400,0,0
maksssksksss113.png,with_mask,294,115,308,130,14,15,267,400,0,0
maksssksksss113.png,without_mask,228,119,241,134,13,15,267,400,0,0
maksssksksss114.png,without_mask,4,83,75,161,71,78,225,400,0,0
maksssksksss114.png,with_mask,80,58,153,141,73,83,225,400,0,0
maksssksksss115.png,with_mask,24,67,47,91,23,24,267,400,0,0
maksssksksss115.png,with_mask,79,91,103,112,24,21,267,400,0,0
maksssksksss115.png,with_mask,109,80,128,101,19,21,267,400,0,0
maksssksksss115.png,with_mask,137,88,159,110,22,22,267,400,0,0
maksssksksss115.png,with_mask,179,107,205,134,26,27,267,400,0,0
maksssksksss115.png,with_mask,254,105,278,128,24,23,267,400,0,0
maksssksksss115.png,with_mask,221,78,244,100,23,22,267,400,0,0
maksssksksss115.png,with_mask,172,86,183,107,11,21,267,400,0,0
maksssksksss115.png,with_mask,185,85,209,104,24,19,267,400,0,0
maksssksksss116.png,with_mask,116,88,150,122,34,34,225,400,0,0
maksssksksss116.png,with_mask,160,79,193,118,33,39,225,400,0,0
maksssksksss116.png,with_mask,235,43,272,87,37,44,225,400,0,0
maksssksksss116.png,with_mask,304,68,336,102,32,34,225,400,0,0
maksssksksss116.png,with_mask,379,61,399,96,20,35,225,400,0,0
maksssksksss117.png,with_mask,131,224,227,346,96,122,400,301,0,0
maksssksksss118.png,with_mask,138,79,176,116,38,37,267,400,0,0
maksssksksss118.png,with_mask,217,70,255,107,38,37,267,400,0,0
maksssksksss119.png,with_mask,54,92,82,120,28,28,289,400,0,0
maksssksksss119.png,with_mask,132,47,153,71,21,24,289,400,0,0
maksssksksss119.png,with_mask,242,94,268,125,26,31,289,400,0,0
maksssksksss119.png,with_mask,254,51,266,64,12,13,289,400,0,0
maksssksksss119.png,with_mask,263,79,275,92,12,13,289,400,0,0
maksssksksss119.png,without_mask,302,81,330,107,28,26,289,400,0,0
maksssksksss119.png,without_mask,352,45,377,67,25,22,289,400,0,0
maksssksksss12.png,with_mask,72,71,90,88,18,17,272,400,0,0
maksssksksss12.png,with_mask,119,70,137,88,18,18,272,400,0,0
maksssksksss12.png,with_mask,163,76,185,96,22,20,272,400,0,0
maksssksksss12.png,with_mask,120,55,132,68,12,13,272,400,0,0
maksssksksss12.png,with_mask,153,61,171,81,18,20,272,400,0,0
maksssksksss12.png,with_mask,335,70,353,87,18,17,272,400,0,0
maksssksksss12.png,with_mask,273,58,290,75,17,17,272,400,0,0
maksssksksss12.png,with_mask,232,61,249,78,17,17,272,400,0,0
maksssksksss12.png,without_mask,298,61,312,84,14,23,272,400,0,0
maksssksksss12.png,with_mask,354,54,365,68,11,14,272,400,0,0
maksssksksss120.png,with_mask,59,185,183,336,124,151,400,301,0,0
maksssksksss121.png,without_mask,11,48,41,75,30,27,300,400,0,0
maksssksksss121.png,without_mask,91,41,121,72,30,31,300,400,0,0
maksssksksss121.png,without_mask,176,56,204,83,28,27,300,400,0,0
maksssksksss121.png,without_mask,239,56,266,81,27,25,300,400,0,0
maksssksksss121.png,without_mask,301,62,329,87,28,25,300,400,0,0
maksssksksss121.png,without_mask,343,74,368,97,25,23,300,400,0,0
maksssksksss121.png,without_mask,387,82,400,107,13,25,300,400,0,0
maksssksksss122.png,with_mask,201,38,345,213,144,175,267,400,0,0
maksssksksss123.png,with_mask,92,106,191,224,99,118,301,400,0,0
maksssksksss123.png,with_mask,227,129,321,229,94,100,301,400,0,0
maksssksksss124.png,with_mask,91,146,143,204,52,58,271,400,0,0
maksssksksss124.png,with_mask,239,126,290,182,51,56,271,400,0,0
maksssksksss124.png,with_mask,378,146,399,171,21,25,271,400,0,0
maksssksksss124.png,without_mask,1,170,20,196,19,26,271,400,0,0
maksssksksss124.png,without_mask,333,133,360,170,27,37,271,400,0,0
maksssksksss125.png,without_mask,118,151,216,279,98,128,400,301,0,0
maksssksksss126.png,with_mask,106,45,158,104,52,59,400,267,0,0
maksssksksss126.png,with_mask,194,62,215,88,21,26,400,267,0,0
maksssksksss126.png,without_mask,226,2,267,97,41,95,400,267,0,0
maksssksksss127.png,with_mask,98,46,130,80,32,34,400,267,0,0
maksssksksss128.png,without_mask,93,183,194,295,101,112,400,301,0,0
maksssksksss129.png,without_mask,106,69,124,89,18,20,295,400,0,0
maksssksksss129.png,without_mask,149,30,168,53,19,23,295,400,0,0
maksssksksss129.png,with_mask,246,40,271,69,25,29,295,400,0,0
maksssksksss13.png,with_mask,28,54,44,71,16,17,226,400,0,0
maksssksksss13.png,with_mask,98,62,114,80,16,18,226,400,0,0
maksssksksss13.png,mask_weared_incorrect,162,51,194,89,32,38,226,400,0,0
maksssksksss13.png,with_mask,293,60,313,81,20,21,226,400,0,0
maksssksksss13.png,with_mask,352,53,373,71,21,18,226,400,0,0
maksssksksss13.png,with_mask,229,53,241,72,12,19,226,400,0,0
maksssksksss130.png,mask_weared_incorrect,7,104,46,147,39,43,400,332,0,0
maksssksksss130.png,mask_weared_incorrect,162,58,208,112,46,54,400,332,0,0
maksssksksss130.png,without_mask,304,95,332,141,28,46,400,332,0,0
maksssksksss130.png,without_mask,198,95,223,136,25,41,400,332,0,0
maksssksksss131.png,with_mask,65,63,110,112,45,49,267,400,0,0
maksssksksss131.png,with_mask,127,31,166,76,39,45,267,400,0,0
maksssksksss131.png,without_mask,257,55,284,86,27,31,267,400,0,0
maksssksksss131.png,with_mask,284,66,321,107,37,41,267,400,0,0
maksssksksss131.png,without_mask,252,125,295,167,43,42,267,400,0,0
maksssksksss131.png,with_mask,345,93,363,116,18,23,267,400,0,0
maksssksksss131.png,without_mask,236,74,256,99,20,25,267,400,0,0
maksssksksss131.png,without_mask,216,63,237,83,21,20,267,400,0,0
maksssksksss132.png,mask_weared_incorrect,106,72,190,182,84,110,400,306,0,0
maksssksksss133.png,with_mask,100,179,221,318,121,139,400,301,0,0
maksssksksss134.png,with_mask,92,19,117,50,25,31,225,400,0,0
maksssksksss134.png,without_mask,156,22,177,48,21,26,225,400,0,0
maksssksksss134.png,with_mask,179,24,197,47,18,23,225,400,0,0
maksssksksss134.png,with_mask,183,74,205,100,22,26,225,400,0,0
maksssksksss134.png,with_mask,269,70,285,89,16,19,225,400,0,0
maksssksksss134.png,without_mask,343,15,359,34,16,19,225,400,0,0
maksssksksss134.png,with_mask,302,43,318,59,16,16,225,400,0,0
maksssksksss135.png,with_mask,49,157,144,225,95,68,225,400,0,0
maksssksksss135.png,with_mask,151,67,270,198,119,131,225,400,0,0
maksssksksss136.png,with_mask,100,105,152,158,52,53,400,267,0,0
maksssksksss137.png,without_mask,38,143,53,161,15,18,400,400,0,0
maksssksksss137.png,without_mask,76,146,95,164,19,18,400,400,0,0
maksssksksss137.png,with_mask,114,142,131,163,17,21,400,400,0,0
maksssksksss137.png,with_mask,158,165,175,185,17,20,400,400,0,0
maksssksksss137.png,without_mask,217,153,241,174,24,21,400,400,0,0
maksssksksss137.png,without_mask,283,158,310,181,27,23,400,400,0,0
maksssksksss138.png,with_mask,51,144,128,239,77,95,267,400,0,0
maksssksksss138.png,with_mask,147,169,217,233,70,64,267,400,0,0
maksssksksss138.png,with_mask,224,92,309,186,85,94,267,400,0,0
maksssksksss139.png,with_mask,2,28,19,46,17,18,225,400,0,0
maksssksksss139.png,with_mask,23,36,45,59,22,23,225,400,0,0
maksssksksss139.png,without_mask,30,71,51,92,21,21,225,400,0,0
maksssksksss139.png,with_mask,4,177,35,209,31,32,225,400,0,0
maksssksksss139.png,with_mask,93,15,117,34,24,19,225,400,0,0
maksssksksss139.png,with_mask,99,74,122,100,23,26,225,400,0,0
maksssksksss139.png,mask_weared_incorrect,56,132,79,162,23,30,225,400,0,0
maksssksksss139.png,with_mask,36,152,65,183,29,31,225,400,0,0
maksssksksss139.png,with_mask,138,191,165,221,27,30,225,400,0,0
maksssksksss139.png,with_mask,182,13,209,36,27,23,225,400,0,0
maksssksksss139.png,with_mask,188,55,213,80,25,25,225,400,0,0
maksssksksss139.png,with_mask,196,146,219,168,23,22,225,400,0,0
maksssksksss139.png,with_mask,213,164,243,193,30,29,225,400,0,0
maksssksksss139.png,with_mask,253,13,277,35,24,22,225,400,0,0
maksssksksss139.png,with_mask,246,73,268,98,22,25,225,400,0,0
maksssksksss139.png,with_mask,286,10,314,38,28,28,225,400,0,0
maksssksksss139.png,with_mask,320,1,341,15,21,14,225,400,0,0
maksssksksss139.png,with_mask,345,34,372,57,27,23,225,400,0,0
maksssksksss139.png,with_mask,358,116,388,141,30,25,225,400,0,0
maksssksksss14.png,without_mask,152,192,239,319,87,127,400,301,0,0
maksssksksss140.png,with_mask,37,74,188,247,151,173,267,400,0,0
maksssksksss140.png,with_mask,210,114,336,255,126,141,267,400,0,0
maksssksksss141.png,with_mask,129,96,175,155,46,59,267,400,0,0
maksssksksss141.png,with_mask,220,123,260,169,40,46,267,400,0,0
maksssksksss142.png,with_mask,144,110,244,235,100,125,359,479,0,0
maksssksksss143.png,with_mask,102,200,194,333,92,133,400,301,0,0
maksssksksss144.png,with_mask,130,19,155,47,25,28,217,400,0,0
maksssksksss144.png,with_mask,212,56,232,79,20,23,217,400,0,0
maksssksksss144.png,with_mask,298,60,316,80,18,20,217,400,0,0
maksssksksss145.png,mask_weared_incorrect,91,89,114,111,23,22,226,400,0,0
maksssksksss145.png,mask_weared_incorrect,183,102,203,122,20,20,226,400,0,0
maksssksksss145.png,without_mask,310,96,333,119,23,23,226,400,0,0
maksssksksss146.png,with_mask,119,122,184,192,65,70,267,400,0,0
maksssksksss146.png,with_mask,265,90,324,153,59,63,267,400,0,0
maksssksksss147.png,without_mask,103,9,120,33,17,24,250,400,0,0
maksssksksss147.png,with_mask,198,15,218,36,20,21,250,400,0,0
maksssksksss147.png,with_mask,224,89,243,109,19,20,250,400,0,0
maksssksksss147.png,with_mask,272,33,294,55,22,22,250,400,0,0
maksssksksss148.png,with_mask,1,20,81,136,80,116,364,400,0,0
maksssksksss148.png,without_mask,68,95,124,157,56,62,364,400,0,0
maksssksksss148.png,without_mask,116,104,140,144,24,40,364,400,0,0
maksssksksss148.png,with_mask,151,89,247,205,96,116,364,400,0,0
maksssksksss148.png,without_mask,325,77,397,156,72,79,364,400,0,0
maksssksksss148.png,with_mask,243,120,283,179,40,59,364,400,0,0
maksssksksss149.png,with_mask,38,98,71,130,33,32,283,400,0,0
maksssksksss149.png,with_mask,180,103,215,136,35,33,283,400,0,0
maksssksksss149.png,with_mask,287,53,315,85,28,32,283,400,0,0
maksssksksss149.png,with_mask,315,57,341,89,26,32,283,400,0,0
maksssksksss149.png,with_mask,330,104,359,133,29,29,283,400,0,0
maksssksksss149.png,with_mask,324,180,348,210,24,30,283,400,0,0
maksssksksss15.png,with_mask,59,144,125,213,66,69,400,193,0,0
maksssksksss15.png,with_mask,82,330,118,366,36,36,400,193,0,0
maksssksksss150.png,with_mask,60,136,164,260,104,124,400,301,0,0
maksssksksss152.png,with_mask,66,25,82,48,16,23,283,400,0,0
maksssksksss152.png,with_mask,101,41,124,68,23,27,283,400,0,0
maksssksksss152.png,with_mask,173,34,193,60,20,26,283,400,0,0
maksssksksss152.png,with_mask,204,75,225,99,21,24,283,400,0,0
maksssksksss152.png,with_mask,289,25,312,54,23,29,283,400,0,0
maksssksksss152.png,with_mask,350,17,368,39,18,22,283,400,0,0
maksssksksss152.png,with_mask,152,50,167,65,15,15,283,400,0,0
maksssksksss153.png,with_mask,89,21,112,44,23,23,268,400,0,0
maksssksksss153.png,without_mask,289,21,311,44,22,23,268,400,0,0
maksssksksss154.png,without_mask,90,200,184,333,94,133,400,301,0,0
maksssksksss155.png,with_mask,43,108,107,174,64,66,225,400,0,0
maksssksksss155.png,with_mask,77,53,163,140,86,87,225,400,0,0
maksssksksss155.png,with_mask,278,92,314,137,36,45,225,400,0,0
maksssksksss155.png,with_mask,381,97,392,111,11,14,225,400,0,0
maksssksksss156.png,with_mask,327,33,352,59,25,26,267,400,0,0
maksssksksss156.png,with_mask,27,47,47,65,20,18,267,400,0,0
maksssksksss156.png,with_mask,249,43,268,63,19,20,267,400,0,0
maksssksksss156.png,with_mask,278,73,291,87,13,14,267,400,0,0
maksssksksss156.png,mask_weared_incorrect,366,70,385,91,19,21,267,400,0,0
maksssksksss156.png,mask_weared_incorrect,181,40,203,67,22,27,267,400,0,0
maksssksksss156.png,mask_weared_incorrect,36,63,59,88,23,25,267,400,0,0
maksssksksss156.png,without_mask,1,45,19,64,18,19,267,400,0,0
maksssksksss156.png,without_mask,68,68,90,91,22,23,267,400,0,0
maksssksksss156.png,without_mask,87,55,102,71,15,16,267,400,0,0
maksssksksss156.png,without_mask,137,58,155,74,18,16,267,400,0,0
maksssksksss156.png,without_mask,233,50,250,67,17,17,267,400,0,0
maksssksksss156.png,without_mask,281,33,300,51,19,18,267,400,0,0
maksssksksss157.png,with_mask,22,78,43,98,21,20,225,400,0,0
maksssksksss157.png,without_mask,84,61,111,95,27,34,225,400,0,0
maksssksksss157.png,with_mask,144,78,173,119,29,41,225,400,0,0
maksssksksss157.png,with_mask,193,71,217,97,24,26,225,400,0,0
maksssksksss157.png,with_mask,225,43,259,80,34,37,225,400,0,0
maksssksksss157.png,with_mask,297,62,316,86,19,24,225,400,0,0
maksssksksss157.png,with_mask,320,40,352,74,32,34,225,400,0,0
maksssksksss157.png,with_mask,368,75,395,104,27,29,225,400,0,0
maksssksksss158.png,with_mask,2,56,24,78,22,22,278,400,0,0
maksssksksss158.png,with_mask,29,70,42,85,13,15,278,400,0,0
maksssksksss158.png,with_mask,90,55,104,72,14,17,278,400,0,0
maksssksksss158.png,with_mask,113,52,133,76,20,24,278,400,0,0
maksssksksss158.png,with_mask,133,60,144,74,11,14,278,400,0,0
maksssksksss158.png,with_mask,151,70,166,85,15,15,278,400,0,0
maksssksksss158.png,with_mask,180,70,195,84,15,14,278,400,0,0
maksssksksss158.png,with_mask,217,78,238,98,21,20,278,400,0,0
maksssksksss158.png,with_mask,238,52,256,70,18,18,278,400,0,0
maksssksksss158.png,with_mask,280,59,293,74,13,15,278,400,0,0
maksssksksss158.png,with_mask,293,56,310,75,17,19,278,400,0,0
maksssksksss158.png,with_mask,323,82,342,101,19,19,278,400,0,0
maksssksksss158.png,with_mask,354,64,371,86,17,22,278,400,0,0
maksssksksss159.png,with_mask,5,114,58,178,53,64,225,400,0,0
maksssksksss159.png,with_mask,125,82,136,95,11,13,225,400,0,0
maksssksksss159.png,with_mask,157,82,170,99,13,17,225,400,0,0
maksssksksss159.png,with_mask,213,65,225,79,12,14,225,400,0,0
maksssksksss159.png,with_mask,276,75,288,87,12,12,225,400,0,0
maksssksksss159.png,with_mask,326,32,395,105,69,73,225,400,0,0
maksssksksss16.png,with_mask,48,227,146,345,98,118,400,301,0,0
maksssksksss160.png,with_mask,71,82,151,153,80,71,286,400,0,0
maksssksksss160.png,with_mask,246,107,326,195,80,88,286,400,0,0
maksssksksss161.png,without_mask,123,227,190,328,67,101,400,301,0,0
maksssksksss162.png,with_mask,86,181,191,308,105,127,400,301,0,0
maksssksksss163.png,with_mask,209,108,226,126,17,18,300,400,0,0
maksssksksss163.png,with_mask,161,124,184,152,23,28,300,400,0,0
maksssksksss164.png,with_mask,12,47,40,73,28,26,200,400,0,0
maksssksksss164.png,with_mask,44,51,66,75,22,24,200,400,0,0
maksssksksss164.png,with_mask,80,42,99,63,19,21,200,400,0,0
maksssksksss164.png,without_mask,153,39,179,65,26,26,200,400,0,0
maksssksksss164.png,without_mask,203,35,225,59,22,24,200,400,0,0
maksssksksss164.png,with_mask,256,45,271,63,15,18,200,400,0,0
maksssksksss164.png,with_mask,292,58,311,77,19,19,200,400,0,0
maksssksksss164.png,with_mask,327,64,346,83,19,19,200,400,0,0
maksssksksss164.png,with_mask,361,37,386,64,25,27,200,400,0,0
maksssksksss165.png,with_mask,15,111,114,219,99,108,463,450,0,0
maksssksksss165.png,with_mask,324,135,410,238,86,103,463,450,0,0
maksssksksss166.png,with_mask,98,1,150,58,52,57,267,400,0,0
maksssksksss166.png,with_mask,205,115,235,155,30,40,267,400,0,0
maksssksksss166.png,with_mask,255,141,278,171,23,30,267,400,0,0
maksssksksss166.png,with_mask,303,180,325,207,22,27,267,400,0,0
maksssksksss166.png,with_mask,329,195,347,218,18,23,267,400,0,0
maksssksksss166.png,with_mask,351,204,372,226,21,22,267,400,0,0
maksssksksss167.png,with_mask,45,69,96,113,51,44,210,400,0,0
maksssksksss167.png,with_mask,185,113,222,155,37,42,210,400,0,0
maksssksksss167.png,with_mask,271,32,311,75,40,43,210,400,0,0
maksssksksss168.png,without_mask,40,74,62,90,22,16,225,400,0,0
maksssksksss168.png,with_mask,35,116,51,133,16,17,225,400,0,0
maksssksksss168.png,with_mask,85,79,97,90,12,11,225,400,0,0
maksssksksss168.png,with_mask,169,66,287,188,118,122,225,400,0,0
maksssksksss168.png,without_mask,363,51,384,81,21,30,225,400,0,0
maksssksksss169.png,with_mask,152,262,220,367,68,105,400,301,0,0
maksssksksss17.png,with_mask,73,179,169,297,96,118,400,301,0,0
maksssksksss170.png,with_mask,102,54,239,210,137,156,225,400,0,0
maksssksksss171.png,with_mask,207,122,361,291,154,169,400,400,0,0
maksssksksss172.png,without_mask,96,233,186,341,90,108,400,301,0,0
maksssksksss173.png,with_mask,48,94,72,116,24,22,294,400,0,0
maksssksksss173.png,mask_weared_incorrect,331,77,356,106,25,29,294,400,0,0
maksssksksss174.png,with_mask,44,63,95,117,51,54,272,400,0,0
maksssksksss174.png,with_mask,102,60,142,104,40,44,272,400,0,0
maksssksksss174.png,with_mask,196,44,250,100,54,56,272,400,0,0
maksssksksss174.png,with_mask,351,54,392,102,41,48,272,400,0,0
maksssksksss175.png,with_mask,113,61,174,122,61,61,226,400,0,0
maksssksksss175.png,with_mask,195,50,228,112,33,62,226,400,0,0
maksssksksss176.png,with_mask,132,55,157,97,25,42,225,400,0,0
maksssksksss176.png,with_mask,15,68,47,104,32,36,225,400,0,0
maksssksksss176.png,with_mask,55,47,81,80,26,33,225,400,0,0
maksssksksss176.png,with_mask,144,95,169,128,25,33,225,400,0,0
maksssksksss176.png,with_mask,166,66,189,95,23,29,225,400,0,0
maksssksksss176.png,with_mask,222,47,260,82,38,35,225,400,0,0
maksssksksss176.png,with_mask,89,60,104,86,15,26,225,400,0,0
maksssksksss176.png,mask_weared_incorrect,237,86,277,135,40,49,225,400,0,0
maksssksksss176.png,without_mask,291,79,319,115,28,36,225,400,0,0
maksssksksss176.png,without_mask,371,63,392,90,21,27,225,400,0,0
maksssksksss176.png,without_mask,387,59,400,92,13,33,225,400,0,0
maksssksksss177.png,with_mask,276,76,324,118,48,42,300,400,0,0
maksssksksss177.png,with_mask,154,147,199,194,45,47,300,400,0,0
maksssksksss178.png,with_mask,91,41,126,76,35,35,400,268,0,0
maksssksksss178.png,without_mask,193,86,214,112,21,26,400,268,0,0
maksssksksss178.png,without_mask,245,90,265,112,20,22,400,268,0,0
maksssksksss179.png,with_mask,170,26,199,57,29,31,267,400,0,0
maksssksksss179.png,with_mask,45,57,62,76,17,19,267,400,0,0
maksssksksss179.png,without_mask,47,81,64,99,17,18,267,400,0,0
maksssksksss179.png,without_mask,89,53,116,76,27,23,267,400,0,0
maksssksksss18.png,with_mask,134,86,192,148,58,62,267,400,0,0
maksssksksss18.png,with_mask,299,159,354,217,55,58,267,400,0,0
maksssksksss180.png,with_mask,58,182,165,316,107,134,400,301,0,0
maksssksksss181.png,with_mask,70,58,93,82,23,24,225,400,0,0
maksssksksss181.png,with_mask,100,57,124,82,24,25,225,400,0,0
maksssksksss181.png,without_mask,271,43,305,80,34,37,225,400,0,0
maksssksksss182.png,without_mask,117,48,167,98,50,50,267,400,0,0
maksssksksss182.png,with_mask,206,49,271,109,65,60,267,400,0,0
maksssksksss183.png,with_mask,158,63,189,99,31,36,225,400,0,0
maksssksksss183.png,with_mask,198,56,241,104,43,48,225,400,0,0
maksssksksss183.png,without_mask,372,108,390,128,18,20,225,400,0,0
maksssksksss183.png,without_mask,35,109,50,130,15,21,225,400,0,0
maksssksksss184.png,with_mask,143,44,169,73,26,29,220,400,0,0
maksssksksss184.png,with_mask,171,37,195,65,24,28,220,400,0,0
maksssksksss184.png,with_mask,250,25,274,46,24,21,220,400,0,0
maksssksksss184.png,with_mask,256,49,283,76,27,27,220,400,0,0
maksssksksss184.png,with_mask,262,116,294,145,32,29,220,400,0,0
maksssksksss184.png,with_mask,294,43,316,63,22,20,220,400,0,0
maksssksksss184.png,with_mask,334,38,350,57,16,19,220,400,0,0
maksssksksss184.png,with_mask,320,40,335,57,15,17,220,400,0,0
maksssksksss184.png,with_mask,374,47,386,61,12,14,220,400,0,0
maksssksksss184.png,with_mask,83,11,109,49,26,38,220,400,0,0
maksssksksss185.png,with_mask,89,139,121,187,32,48,267,400,0,0
maksssksksss185.png,with_mask,115,112,139,154,24,42,267,400,0,0
maksssksksss185.png,with_mask,165,102,195,126,30,24,267,400,0,0
maksssksksss185.png,with_mask,270,69,288,86,18,17,267,400,0,0
maksssksksss186.png,with_mask,87,56,135,119,48,63,400,267,0,0
maksssksksss187.png,with_mask,230,97,320,182,90,85,300,400,0,0
maksssksksss188.png,with_mask,99,205,198,318,99,113,400,301,0,0
maksssksksss189.png,without_mask,124,48,143,96,19,48,200,400,0,0
maksssksksss189.png,without_mask,201,89,235,121,34,32,200,400,0,0
maksssksksss189.png,with_mask,226,15,271,66,45,51,200,400,0,0
maksssksksss19.png,without_mask,1,45,18,68,17,23,236,400,0,0
maksssksksss19.png,with_mask,89,38,115,62,26,24,236,400,0,0
maksssksksss19.png,without_mask,161,20,195,54,34,34,236,400,0,0
maksssksksss19.png,with_mask,104,104,182,175,78,71,236,400,0,0
maksssksksss19.png,with_mask,309,77,375,136,66,59,236,400,0,0
maksssksksss19.png,without_mask,267,14,287,32,20,18,236,400,0,0
maksssksksss190.png,with_mask,143,75,222,155,79,80,282,400,0,0
maksssksksss191.png,with_mask,221,82,297,163,76,81,301,400,0,0
maksssksksss192.png,with_mask,112,40,157,87,45,47,400,267,0,0
maksssksksss193.png,with_mask,13,175,97,254,84,79,400,300,0,0
maksssksksss193.png,with_mask,133,56,258,172,125,116,400,300,0,0
maksssksksss194.png,with_mask,184,69,199,87,15,18,267,400,0,0
maksssksksss194.png,without_mask,205,67,216,78,11,11,267,400,0,0
maksssksksss195.png,with_mask,121,145,305,356,184,211,400,400,0,0
maksssksksss196.png,with_mask,83,250,154,362,71,112,400,301,0,0
maksssksksss197.png,with_mask,169,84,213,128,44,44,226,400,0,0
maksssksksss198.png,with_mask,118,19,295,184,177,165,225,400,0,0
maksssksksss199.png,with_mask,320,113,333,127,13,14,276,400,0,0
maksssksksss2.png,with_mask,68,42,105,69,37,27,290,400,0,0
maksssksksss2.png,with_mask,154,47,178,74,24,27,290,400,0,0
maksssksksss2.png,with_mask,238,34,262,69,24,35,290,400,0,0
maksssksksss2.png,mask_weared_incorrect,333,31,366,65,33,34,290,400,0,0
maksssksksss20.png,with_mask,93,60,153,124,60,64,400,267,0,0
maksssksksss200.png,with_mask,5,185,110,287,105,102,400,301,0,0
maksssksksss200.png,with_mask,115,130,180,192,65,62,400,301,0,0
maksssksksss200.png,with_mask,215,94,301,195,86,101,400,301,0,0
maksssksksss201.png,with_mask,33,82,76,127,43,45,226,400,0,0
maksssksksss201.png,with_mask,59,64,88,98,29,34,226,400,0,0
maksssksksss201.png,with_mask,36,40,55,61,19,21,226,400,0,0
maksssksksss201.png,with_mask,101,70,162,132,61,62,226,400,0,0
maksssksksss201.png,with_mask,69,29,89,49,20,20,226,400,0,0
maksssksksss201.png,with_mask,223,91,265,127,42,36,226,400,0,0
maksssksksss201.png,with_mask,240,28,268,52,28,24,226,400,0,0
maksssksksss201.png,with_mask,286,56,318,90,32,34,226,400,0,0
maksssksksss201.png,with_mask,370,36,398,65,28,29,226,400,0,0
maksssksksss201.png,with_mask,1,45,16,70,15,25,226,400,0,0
maksssksksss202.png,with_mask,15,158,35,187,20,29,300,400,0,0
maksssksksss202.png,with_mask,46,126,70,153,24,27,300,400,0,0
maksssksksss202.png,with_mask,92,99,120,132,28,33,300,400,0,0
maksssksksss202.png,with_mask,180,127,213,165,33,38,300,400,0,0
maksssksksss202.png,with_mask,300,135,332,169,32,34,300,400,0,0
maksssksksss202.png,with_mask,348,154,371,181,23,27,300,400,0,0
maksssksksss203.png,with_mask,11,28,37,57,26,29,225,400,0,0
maksssksksss203.png,with_mask,100,42,124,67,24,25,225,400,0,0
maksssksksss203.png,with_mask,236,48,255,70,19,22,225,400,0,0
maksssksksss203.png,with_mask,304,42,329,64,25,22,225,400,0,0
maksssksksss204.png,with_mask,73,133,118,188,45,55,266,400,0,0
maksssksksss204.png,with_mask,137,103,175,143,38,40,266,400,0,0
maksssksksss204.png,with_mask,175,96,203,121,28,25,266,400,0,0
maksssksksss204.png,with_mask,220,91,252,123,32,32,266,400,0,0
maksssksksss204.png,with_mask,254,101,294,144,40,43,266,400,0,0
maksssksksss204.png,with_mask,278,51,313,88,35,37,266,400,0,0
maksssksksss204.png,with_mask,27,113,45,139,18,26,266,400,0,0
maksssksksss205.png,with_mask,86,244,156,346,70,102,400,301,0,0
maksssksksss206.png,with_mask,82,75,122,119,40,44,298,400,0,0
maksssksksss206.png,with_mask,171,67,206,108,35,41,298,400,0,0
maksssksksss206.png,with_mask,270,35,318,83,48,48,298,400,0,0
maksssksksss206.png,mask_weared_incorrect,68,98,83,115,15,17,298,400,0,0
maksssksksss207.png,with_mask,34,87,51,103,17,16,267,400,0,0
maksssksksss207.png,with_mask,167,91,211,140,44,49,267,400,0,0
maksssksksss207.png,with_mask,281,95,316,125,35,30,267,400,0,0
maksssksksss207.png,with_mask,347,87,400,171,53,84,267,400,0,0
maksssksksss208.png,with_mask,84,82,194,170,110,88,200,400,0,0
maksssksksss208.png,with_mask,192,71,298,187,106,116,200,400,0,0
maksssksksss209.png,without_mask,37,50,63,78,26,28,210,400,0,0
maksssksksss209.png,without_mask,63,79,88,101,25,22,210,400,0,0
maksssksksss209.png,without_mask,64,112,91,141,27,29,210,400,0,0
maksssksksss209.png,without_mask,88,44,112,72,24,28,210,400,0,0
maksssksksss209.png,without_mask,120,99,150,133,30,34,210,400,0,0
maksssksksss209.png,with_mask,161,102,197,143,36,41,210,400,0,0
maksssksksss209.png,without_mask,206,51,228,79,22,28,210,400,0,0
maksssksksss209.png,without_mask,227,124,260,157,33,33,210,400,0,0
maksssksksss209.png,without_mask,236,91,262,119,26,28,210,400,0,0
maksssksksss209.png,with_mask,338,116,370,155,32,39,210,400,0,0
maksssksksss209.png,without_mask,374,63,396,88,22,25,210,400,0,0
maksssksksss209.png,without_mask,267,22,289,44,22,22,210,400,0,0
maksssksksss209.png,without_mask,344,35,361,52,17,17,210,400,0,0
maksssksksss209.png,without_mask,183,49,205,69,22,20,210,400,0,0
maksssksksss21.png,with_mask,40,137,109,218,69,81,227,400,0,0
maksssksksss21.png,with_mask,54,57,111,112,57,55,227,400,0,0
maksssksksss21.png,with_mask,189,78,246,140,57,62,227,400,0,0
maksssksksss21.png,with_mask,311,48,358,98,47,50,227,400,0,0
maksssksksss21.png,without_mask,182,32,221,60,39,28,227,400,0,0
maksssksksss210.png,with_mask,92,203,205,356,113,153,400,301,0,0
maksssksksss211.png,with_mask,144,99,276,219,132,120,364,400,0,0
maksssksksss212.png,with_mask,115,75,169,135,54,60,400,267,0,0
maksssksksss213.png,with_mask,63,183,174,313,111,130,400,301,0,0
maksssksksss214.png,with_mask,14,61,61,110,47,49,257,400,0,0
maksssksksss214.png,with_mask,151,96,176,121,25,25,257,400,0,0
maksssksksss214.png,with_mask,166,110,199,149,33,39,257,400,0,0
maksssksksss214.png,with_mask,241,109,266,135,25,26,257,400,0,0
maksssksksss214.png,with_mask,286,58,331,112,45,54,257,400,0,0
maksssksksss214.png,with_mask,277,75,288,87,11,12,257,400,0,0
maksssksksss215.png,with_mask,75,75,158,161,83,86,400,400,0,0
maksssksksss215.png,with_mask,245,95,315,171,70,76,400,400,0,0
maksssksksss216.png,with_mask,8,64,43,93,35,29,300,400,0,0
maksssksksss216.png,with_mask,225,44,261,93,36,49,300,400,0,0
maksssksksss216.png,with_mask,208,52,225,77,17,25,300,400,0,0
maksssksksss216.png,with_mask,328,48,348,66,20,18,300,400,0,0
maksssksksss216.png,without_mask,138,55,169,82,31,27,300,400,0,0
maksssksksss217.png,without_mask,115,202,218,341,103,139,400,301,0,0
maksssksksss218.png,without_mask,139,223,251,371,112,148,400,301,0,0
maksssksksss219.png,with_mask,120,122,184,194,64,72,267,400,0,0
maksssksksss219.png,with_mask,266,92,323,151,57,59,267,400,0,0
maksssksksss22.png,with_mask,183,101,270,185,87,84,268,400,0,0
maksssksksss220.png,with_mask,113,58,162,104,49,46,400,267,0,0
maksssksksss221.png,with_mask,21,211,53,242,32,31,300,400,0,0
maksssksksss221.png,with_mask,129,187,161,219,32,32,300,400,0,0
maksssksksss221.png,with_mask,208,189,234,223,26,34,300,400,0,0
maksssksksss221.png,with_mask,350,217,395,251,45,34,300,400,0,0
maksssksksss221.png,with_mask,377,151,389,162,12,11,300,400,0,0
maksssksksss222.png,with_mask,24,50,44,71,20,21,226,400,0,0
maksssksksss222.png,with_mask,59,63,77,83,18,20,226,400,0,0
maksssksksss222.png,with_mask,129,56,152,79,23,23,226,400,0,0
maksssksksss222.png,with_mask,154,54,171,74,17,20,226,400,0,0
maksssksksss222.png,with_mask,170,104,192,128,22,24,226,400,0,0
maksssksksss222.png,with_mask,186,55,198,69,12,14,226,400,0,0
maksssksksss222.png,with_mask,206,50,217,69,11,19,226,400,0,0
maksssksksss222.png,with_mask,216,52,233,73,17,21,226,400,0,0
maksssksksss222.png,with_mask,238,61,253,79,15,18,226,400,0,0
maksssksksss222.png,with_mask,252,68,269,89,17,21,226,400,0,0
maksssksksss222.png,with_mask,275,71,297,96,22,25,226,400,0,0
maksssksksss222.png,with_mask,300,49,314,66,14,17,226,400,0,0
maksssksksss222.png,without_mask,315,52,332,65,17,13,226,400,0,0
maksssksksss222.png,with_mask,344,43,362,62,18,19,226,400,0,0
maksssksksss222.png,with_mask,366,47,386,68,20,21,226,400,0,0
maksssksksss222.png,with_mask,140,45,155,60,15,15,226,400,0,0
maksssksksss222.png,with_mask,113,45,128,59,15,14,226,400,0,0
maksssksksss223.png,with_mask,143,92,166,119,23,27,225,400,0,0
maksssksksss223.png,with_mask,138,51,169,67,31,16,225,400,0,0
maksssksksss223.png,with_mask,247,135,271,170,24,35,225,400,0,0
maksssksksss223.png,with_mask,224,105,240,135,16,30,225,400,0,0
maksssksksss223.png,mask_weared_incorrect,100,49,113,61,13,12,225,400,0,0
maksssksksss223.png,without_mask,224,83,239,97,15,14,225,400,0,0
maksssksksss223.png,without_mask,367,76,382,92,15,16,225,400,0,0
maksssksksss223.png,without_mask,371,100,382,123,11,23,225,400,0,0
maksssksksss223.png,without_mask,381,76,393,88,12,12,225,400,0,0
maksssksksss224.png,with_mask,214,112,298,200,84,88,400,400,0,0
maksssksksss225.png,with_mask,116,207,222,354,106,147,400,301,0,0
maksssksksss226.png,with_mask,145,56,209,121,64,65,225,400,0,0
maksssksksss227.png,with_mask,273,87,300,116,27,29,267,400,0,0
maksssksksss227.png,with_mask,344,60,366,88,22,28,267,400,0,0
maksssksksss227.png,with_mask,246,50,271,82,25,32,267,400,0,0
maksssksksss227.png,with_mask,146,104,169,126,23,22,267,400,0,0
maksssksksss227.png,with_mask,163,80,184,103,21,23,267,400,0,0
maksssksksss227.png,with_mask,1,69,33,130,32,61,267,400,0,0
maksssksksss227.png,with_mask,124,86,142,104,18,18,267,400,0,0
maksssksksss227.png,with_mask,98,78,119,96,21,18,267,400,0,0
maksssksksss227.png,with_mask,31,78,46,93,15,15,267,400,0,0
maksssksksss227.png,with_mask,72,78,88,91,16,13,267,400,0,0
maksssksksss227.png,with_mask,200,70,211,82,11,12,267,400,0,0
maksssksksss228.png,with_mask,46,191,147,324,101,133,400,301,0,0
maksssksksss229.png,with_mask,29,90,60,133,31,43,226,400,0,0
maksssksksss229.png,with_mask,92,57,128,88,36,31,226,400,0,0
maksssksksss229.png,with_mask,26,42,45,61,19,19,226,400,0,0
maksssksksss229.png,with_mask,123,12,140,31,17,19,226,400,0,0
maksssksksss229.png,with_mask,175,64,196,86,21,22,226,400,0,0
maksssksksss229.png,with_mask,203,50,218,70,15,20,226,400,0,0
maksssksksss229.png,with_mask,243,52,257,74,14,22,226,400,0,0
maksssksksss229.png,with_mask,218,91,242,117,24,26,226,400,0,0
maksssksksss229.png,with_mask,231,138,255,167,24,29,226,400,0,0
maksssksksss229.png,with_mask,293,87,320,110,27,23,226,400,0,0
maksssksksss229.png,with_mask,235,5,246,21,11,16,226,400,0,0
maksssksksss229.png,with_mask,370,32,398,63,28,31,226,400,0,0
maksssksksss23.png,with_mask,188,74,241,131,53,57,299,400,0,0
maksssksksss230.png,with_mask,16,191,92,265,76,74,367,512,0,0
maksssksksss230.png,with_mask,124,92,183,147,59,55,367,512,0,0
maksssksksss230.png,with_mask,196,39,249,93,53,54,367,512,0,0
maksssksksss230.png,with_mask,307,180,388,260,81,80,367,512,0,0
maksssksksss230.png,with_mask,424,153,512,242,88,89,367,512,0,0
maksssksksss231.png,with_mask,9,55,29,79,20,24,249,400,0,0
maksssksksss231.png,with_mask,32,50,56,74,24,24,249,400,0,0
maksssksksss231.png,with_mask,102,26,120,49,18,23,249,400,0,0
maksssksksss231.png,with_mask,87,73,105,99,18,26,249,400,0,0
maksssksksss231.png,with_mask,117,63,137,88,20,25,249,400,0,0
maksssksksss231.png,with_mask,148,65,171,91,23,26,249,400,0,0
maksssksksss231.png,with_mask,168,47,191,70,23,23,249,400,0,0
maksssksksss231.png,with_mask,194,59,217,84,23,25,249,400,0,0
maksssksksss231.png,with_mask,217,50,241,76,24,26,249,400,0,0
maksssksksss231.png,with_mask,268,59,288,81,20,22,249,400,0,0
maksssksksss231.png,with_mask,291,59,308,85,17,26,249,400,0,0
maksssksksss231.png,with_mask,323,49,349,77,26,28,249,400,0,0
maksssksksss231.png,with_mask,366,47,390,73,24,26,249,400,0,0
maksssksksss231.png,with_mask,127,39,148,61,21,22,249,400,0,0
maksssksksss232.png,with_mask,45,86,72,109,27,23,300,400,0,0
maksssksksss232.png,with_mask,115,74,130,92,15,18,300,400,0,0
maksssksksss232.png,with_mask,161,79,177,93,16,14,300,400,0,0
maksssksksss232.png,with_mask,222,78,233,92,11,14,300,400,0,0
maksssksksss233.png,with_mask,109,117,180,198,71,81,400,358,0,0
maksssksksss234.png,with_mask,175,40,220,86,45,46,225,400,0,0
maksssksksss234.png,with_mask,112,101,123,112,11,11,225,400,0,0
maksssksksss234.png,with_mask,388,122,400,133,12,11,225,400,0,0
maksssksksss234.png,with_mask,341,125,352,136,11,11,225,400,0,0
maksssksksss235.png,with_mask,310,80,342,116,32,36,300,400,0,0
maksssksksss235.png,with_mask,247,106,264,118,17,12,300,400,0,0
maksssksksss236.png,without_mask,163,164,269,299,106,135,400,301,0,0
maksssksksss237.png,with_mask,50,56,64,71,14,15,267,400,0,0
maksssksksss237.png,with_mask,191,37,232,83,41,46,267,400,0,0
maksssksksss238.png,with_mask,27,64,44,84,17,20,267,400,0,0
maksssksksss238.png,with_mask,56,72,72,93,16,21,267,400,0,0
maksssksksss238.png,with_mask,103,58,120,78,17,20,267,400,0,0
maksssksksss238.png,with_mask,152,89,169,108,17,19,267,400,0,0
maksssksksss238.png,with_mask,159,60,175,74,16,14,267,400,0,0
maksssksksss238.png,with_mask,213,47,229,67,16,20,267,400,0,0
maksssksksss238.png,with_mask,278,69,293,91,15,22,267,400,0,0
maksssksksss238.png,with_mask,328,69,344,86,16,17,267,400,0,0
maksssksksss238.png,with_mask,354,75,369,93,15,18,267,400,0,0
maksssksksss239.png,without_mask,91,208,189,317,98,109,400,301,0,0
maksssksksss24.png,mask_weared_incorrect,105,76,161,116,56,40,400,267,0,0
maksssksksss240.png,without_mask,44,215,62,231,18,16,245,400,0,0
maksssksksss240.png,without_mask,4,158,20,174,16,16,245,400,0,0
maksssksksss240.png,without_mask,53,160,68,176,15,16,245,400,0,0
maksssksksss240.png,without_mask,11,134,25,148,14,14,245,400,0,0
maksssksksss240.png,without_mask,58,123,75,139,17,16,245,400,0,0
maksssksksss240.png,without_mask,16,100,31,115,15,15,245,400,0,0
maksssksksss240.png,without_mask,75,89,88,101,13,12,245,400,0,0
maksssksksss240.png,without_mask,20,65,33,78,13,13,245,400,0,0
maksssksksss240.png,without_mask,78,57,92,71,14,14,245,400,0,0
maksssksksss240.png,without_mask,42,23,54,35,12,12,245,400,0,0
maksssksksss240.png,without_mask,77,26,91,40,14,14,245,400,0,0
maksssksksss240.png,without_mask,85,11,98,22,13,11,245,400,0,0
maksssksksss240.png,without_mask,176,30,188,41,12,11,245,400,0,0
maksssksksss240.png,without_mask,178,44,189,55,11,11,245,400,0,0
maksssksksss240.png,without_mask,177,114,189,127,12,13,245,400,0,0
maksssksksss240.png,without_mask,166,136,181,150,15,14,245,400,0,0
maksssksksss240.png,without_mask,181,156,194,167,13,11,245,400,0,0
maksssksksss240.png,without_mask,189,220,206,237,17,17,245,400,0,0
maksssksksss240.png,with_mask,203,103,216,115,13,12,245,400,0,0
maksssksksss240.png,without_mask,215,112,229,127,14,15,245,400,0,0
maksssksksss240.png,without_mask,218,90,232,103,14,13,245,400,0,0
maksssksksss240.png,without_mask,213,51,225,63,12,12,245,400,0,0
maksssksksss240.png,without_mask,230,56,242,68,12,12,245,400,0,0
maksssksksss240.png,without_mask,249,80,262,92,13,12,245,400,0,0
maksssksksss240.png,without_mask,220,158,231,172,11,14,245,400,0,0
maksssksksss240.png,without_mask,233,170,247,184,14,14,245,400,0,0
maksssksksss240.png,without_mask,251,169,264,183,13,14,245,400,0,0
maksssksksss240.png,without_mask,253,128,267,142,14,14,245,400,0,0
maksssksksss240.png,without_mask,250,224,262,238,12,14,245,400,0,0
maksssksksss240.png,without_mask,286,97,299,110,13,13,245,400,0,0
maksssksksss240.png,without_mask,291,124,304,137,13,13,245,400,0,0
maksssksksss240.png,without_mask,287,159,302,170,15,11,245,400,0,0
maksssksksss240.png,without_mask,301,191,315,204,14,13,245,400,0,0
maksssksksss240.png,without_mask,314,231,328,244,14,13,245,400,0,0
maksssksksss241.png,with_mask,172,74,246,147,74,73,210,400,0,0
maksssksksss242.png,with_mask,156,80,222,155,66,75,300,400,0,0
maksssksksss243.png,with_mask,112,93,206,219,94,126,400,301,0,0
maksssksksss244.png,without_mask,53,108,96,149,43,41,262,400,0,0
maksssksksss244.png,with_mask,171,70,225,130,54,60,262,400,0,0
maksssksksss244.png,without_mask,315,34,400,130,85,96,262,400,0,0
maksssksksss245.png,with_mask,32,25,57,54,25,29,210,400,0,0
maksssksksss245.png,with_mask,23,162,38,179,15,17,210,400,0,0
maksssksksss245.png,with_mask,64,164,82,183,18,19,210,400,0,0
maksssksksss245.png,with_mask,168,124,197,154,29,30,210,400,0,0
maksssksksss245.png,with_mask,227,157,248,181,21,24,210,400,0,0
maksssksksss245.png,with_mask,360,15,379,37,19,22,210,400,0,0
maksssksksss245.png,with_mask,339,19,354,39,15,20,210,400,0,0
maksssksksss246.png,with_mask,238,106,266,138,28,32,320,400,0,0
maksssksksss246.png,with_mask,192,130,212,150,20,20,320,400,0,0
maksssksksss246.png,with_mask,21,25,69,78,48,53,320,400,0,0
maksssksksss247.png,with_mask,9,49,37,72,28,23,267,400,0,0
maksssksksss247.png,with_mask,63,43,89,69,26,26,267,400,0,0
maksssksksss247.png,with_mask,112,41,140,68,28,27,267,400,0,0
maksssksksss247.png,with_mask,150,55,175,73,25,18,267,400,0,0
maksssksksss247.png,with_mask,171,52,196,79,25,27,267,400,0,0
maksssksksss247.png,with_mask,270,40,295,78,25,38,267,400,0,0
maksssksksss247.png,with_mask,324,59,353,94,29,35,267,400,0,0
maksssksksss247.png,with_mask,343,128,374,167,31,39,267,400,0,0
maksssksksss247.png,with_mask,307,155,340,185,33,30,267,400,0,0
maksssksksss247.png,with_mask,230,148,259,180,29,32,267,400,0,0
maksssksksss247.png,with_mask,196,116,223,154,27,38,267,400,0,0
maksssksksss247.png,with_mask,122,144,158,174,36,30,267,400,0,0
maksssksksss247.png,with_mask,42,118,71,152,29,34,267,400,0,0
maksssksksss248.png,without_mask,126,186,185,295,59,109,400,301,0,0
maksssksksss249.png,with_mask,168,65,234,139,66,74,267,400,0,0
maksssksksss249.png,without_mask,309,119,368,191,59,72,267,400,0,0
maksssksksss249.png,without_mask,223,89,266,146,43,57,267,400,0,0
maksssksksss25.png,with_mask,122,68,195,152,73,84,400,300,0,0
maksssksksss250.png,with_mask,180,64,222,107,42,43,267,400,0,0
maksssksksss250.png,without_mask,85,65,118,103,33,38,267,400,0,0
maksssksksss250.png,without_mask,135,36,154,64,19,28,267,400,0,0
maksssksksss250.png,mask_weared_incorrect,26,42,59,85,33,43,267,400,0,0
maksssksksss250.png,mask_weared_incorrect,341,32,385,85,44,53,267,400,0,0
maksssksksss251.png,with_mask,28,103,60,140,32,37,206,400,0,0
maksssksksss251.png,with_mask,15,41,41,71,26,30,206,400,0,0
maksssksksss251.png,with_mask,44,10,67,41,23,31,206,400,0,0
maksssksksss251.png,with_mask,78,89,104,124,26,35,206,400,0,0
maksssksksss251.png,with_mask,56,71,78,99,22,28,206,400,0,0
maksssksksss251.png,with_mask,122,103,146,144,24,41,206,400,0,0
maksssksksss251.png,with_mask,91,181,129,206,38,25,206,400,0,0
maksssksksss251.png,with_mask,150,166,194,206,44,40,206,400,0,0
maksssksksss251.png,with_mask,155,57,183,93,28,36,206,400,0,0
maksssksksss251.png,with_mask,125,36,150,66,25,30,206,400,0,0
maksssksksss251.png,with_mask,207,64,231,94,24,30,206,400,0,0
maksssksksss251.png,with_mask,216,146,249,179,33,33,206,400,0,0
maksssksksss251.png,with_mask,240,103,265,140,25,37,206,400,0,0
maksssksksss251.png,with_mask,230,51,256,85,26,34,206,400,0,0
maksssksksss251.png,with_mask,255,13,277,41,22,28,206,400,0,0
maksssksksss251.png,without_mask,206,10,225,30,19,20,206,400,0,0
maksssksksss251.png,with_mask,296,72,319,102,23,30,206,400,0,0
maksssksksss251.png,with_mask,306,120,342,162,36,42,206,400,0,0
maksssksksss251.png,with_mask,333,119,356,151,23,32,206,400,0,0
maksssksksss251.png,with_mask,359,27,384,58,25,31,206,400,0,0
maksssksksss251.png,with_mask,368,3,389,22,21,19,206,400,0,0
maksssksksss251.png,with_mask,327,61,354,90,27,29,206,400,0,0
maksssksksss251.png,with_mask,381,162,400,206,19,44,206,400,0,0
maksssksksss252.png,with_mask,109,65,213,161,104,96,268,400,0,0
maksssksksss253.png,with_mask,118,41,161,91,43,50,300,400,0,0
maksssksksss253.png,with_mask,191,76,208,96,17,20,300,400,0,0
maksssksksss253.png,with_mask,174,125,203,156,29,31,300,400,0,0
maksssksksss253.png,with_mask,209,124,237,151,28,27,300,400,0,0
maksssksksss253.png,with_mask,194,181,233,216,39,35,300,400,0,0
maksssksksss253.png,mask_weared_incorrect,287,144,327,179,40,35,300,400,0,0
maksssksksss253.png,without_mask,226,86,238,98,12,12,300,400,0,0
maksssksksss253.png,without_mask,155,83,172,103,17,20,300,400,0,0
maksssksksss253.png,without_mask,32,57,49,89,17,32,300,400,0,0
maksssksksss253.png,without_mask,385,77,400,93,15,16,300,400,0,0
maksssksksss254.png,without_mask,17,42,55,85,38,43,217,400,0,0
maksssksksss254.png,with_mask,62,91,111,140,49,49,217,400,0,0
maksssksksss254.png,with_mask,167,55,238,133,71,78,217,400,0,0
maksssksksss254.png,with_mask,318,50,376,113,58,63,217,400,0,0
maksssksksss254.png,with_mask,295,71,314,96,19,25,217,400,0,0
maksssksksss254.png,without_mask,374,39,394,70,20,31,217,400,0,0
maksssksksss254.png,with_mask,130,63,152,85,22,22,217,400,0,0
maksssksksss255.png,with_mask,7,95,22,110,15,15,225,400,0,0
maksssksksss255.png,with_mask,33,115,45,130,12,15,225,400,0,0
maksssksksss255.png,with_mask,73,89,94,111,21,22,225,400,0,0
maksssksksss255.png,with_mask,122,99,136,115,14,16,225,400,0,0
maksssksksss255.png,with_mask,149,91,172,113,23,22,225,400,0,0
maksssksksss255.png,with_mask,169,127,195,157,26,30,225,400,0,0
maksssksksss255.png,with_mask,269,105,283,121,14,16,225,400,0,0
maksssksksss255.png,with_mask,308,112,372,181,64,69,225,400,0,0
maksssksksss255.png,with_mask,365,153,389,182,24,29,225,400,0,0
maksssksksss256.png,with_mask,44,47,60,66,16,19,268,400,0,0
maksssksksss256.png,with_mask,89,50,109,70,20,20,268,400,0,0
maksssksksss256.png,with_mask,128,58,144,73,16,15,268,400,0,0
maksssksksss256.png,with_mask,162,21,185,47,23,26,268,400,0,0
maksssksksss256.png,with_mask,189,40,202,53,13,13,268,400,0,0
maksssksksss256.png,with_mask,215,39,235,59,20,20,268,400,0,0
maksssksksss256.png,with_mask,244,90,262,110,18,20,268,400,0,0
maksssksksss256.png,with_mask,265,32,285,52,20,20,268,400,0,0
maksssksksss256.png,with_mask,299,47,318,68,19,21,268,400,0,0
maksssksksss256.png,with_mask,329,55,342,70,13,15,268,400,0,0
maksssksksss256.png,with_mask,344,55,361,71,17,16,268,400,0,0
maksssksksss256.png,with_mask,380,32,400,54,20,22,268,400,0,0
maksssksksss257.png,with_mask,4,106,42,163,38,57,267,400,0,0
maksssksksss257.png,with_mask,41,114,88,163,47,49,267,400,0,0
maksssksksss257.png,with_mask,101,95,143,146,42,51,267,400,0,0
maksssksksss257.png,with_mask,102,17,144,58,42,41,267,400,0,0
maksssksksss257.png,without_mask,24,23,61,56,37,33,267,400,0,0
maksssksksss257.png,with_mask,193,44,232,95,39,51,267,400,0,0
maksssksksss257.png,with_mask,362,89,399,142,37,53,267,400,0,0
maksssksksss257.png,with_mask,342,34,379,71,37,37,267,400,0,0
maksssksksss258.png,mask_weared_incorrect,133,43,194,108,61,65,400,280,0,0
maksssksksss259.png,with_mask,68,213,144,306,76,93,400,301,0,0
maksssksksss26.png,with_mask,73,87,174,206,101,119,400,400,0,0
maksssksksss26.png,with_mask,245,152,327,239,82,87,400,400,0,0
maksssksksss260.png,with_mask,24,236,49,262,25,26,300,400,0,0
maksssksksss260.png,with_mask,77,236,100,262,23,26,300,400,0,0
maksssksksss260.png,with_mask,122,245,144,270,22,25,300,400,0,0
maksssksksss260.png,with_mask,189,258,216,284,27,26,300,400,0,0
maksssksksss260.png,with_mask,306,220,331,242,25,22,300,400,0,0
maksssksksss260.png,with_mask,371,244,393,259,22,15,300,400,0,0
maksssksksss260.png,with_mask,255,187,278,210,23,23,300,400,0,0
maksssksksss260.png,with_mask,331,144,350,162,19,18,300,400,0,0
maksssksksss260.png,with_mask,386,162,399,181,13,19,300,400,0,0
maksssksksss260.png,with_mask,281,144,296,160,15,16,300,400,0,0
maksssksksss260.png,with_mask,207,194,229,215,22,21,300,400,0,0
maksssksksss260.png,with_mask,153,184,175,205,22,21,300,400,0,0
maksssksksss260.png,with_mask,85,166,97,189,12,23,300,400,0,0
maksssksksss260.png,with_mask,65,161,87,185,22,24,300,400,0,0
maksssksksss260.png,with_mask,39,161,59,183,20,22,300,400,0,0
maksssksksss260.png,with_mask,1,112,17,125,16,13,300,400,0,0
maksssksksss260.png,with_mask,44,109,62,127,18,18,300,400,0,0
maksssksksss260.png,with_mask,98,121,114,138,16,17,300,400,0,0
maksssksksss260.png,with_mask,129,118,147,136,18,18,300,400,0,0
maksssksksss260.png,with_mask,178,136,199,154,21,18,300,400,0,0
maksssksksss260.png,with_mask,219,140,239,158,20,18,300,400,0,0
maksssksksss260.png,with_mask,378,98,395,116,17,18,300,400,0,0
maksssksksss260.png,with_mask,321,87,332,105,11,18,300,400,0,0
maksssksksss260.png,with_mask,282,83,298,102,16,19,300,400,0,0
maksssksksss260.png,with_mask,252,85,270,99,18,14,300,400,0,0
maksssksksss260.png,with_mask,208,67,224,85,16,18,300,400,0,0
maksssksksss260.png,with_mask,187,69,201,87,14,18,300,400,0,0
maksssksksss260.png,with_mask,143,56,157,74,14,18,300,400,0,0
maksssksksss260.png,with_mask,111,62,124,78,13,16,300,400,0,0
maksssksksss260.png,with_mask,66,54,79,70,13,16,300,400,0,0
maksssksksss260.png,with_mask,27,52,43,71,16,19,300,400,0,0
maksssksksss260.png,with_mask,1,50,16,67,15,17,300,400,0,0
maksssksksss260.png,with_mask,2,23,14,37,12,14,300,400,0,0
maksssksksss260.png,with_mask,77,35,90,51,13,16,300,400,0,0
maksssksksss260.png,with_mask,128,36,140,53,12,17,300,400,0,0
maksssksksss260.png,with_mask,189,28,200,45,11,17,300,400,0,0
maksssksksss260.png,with_mask,223,37,237,55,14,18,300,400,0,0
maksssksksss260.png,with_mask,272,46,286,64,14,18,300,400,0,0
maksssksksss260.png,with_mask,308,39,324,58,16,19,300,400,0,0
maksssksksss260.png,with_mask,354,50,368,67,14,17,300,400,0,0
maksssksksss260.png,with_mask,321,12,333,26,12,14,300,400,0,0
maksssksksss260.png,with_mask,290,14,304,29,14,15,300,400,0,0
maksssksksss260.png,with_mask,251,11,264,28,13,17,300,400,0,0
maksssksksss260.png,with_mask,200,11,213,25,13,14,300,400,0,0
maksssksksss260.png,with_mask,173,13,186,25,13,12,300,400,0,0
maksssksksss260.png,with_mask,146,8,159,22,13,14,300,400,0,0
maksssksksss260.png,with_mask,110,3,125,17,15,14,300,400,0,0
maksssksksss261.png,with_mask,36,149,69,181,33,32,400,316,0,0
maksssksksss261.png,with_mask,207,64,239,99,32,35,400,316,0,0
maksssksksss261.png,with_mask,213,234,259,277,46,43,400,316,0,0
maksssksksss261.png,without_mask,125,156,159,194,34,38,400,316,0,0
maksssksksss261.png,without_mask,137,100,172,135,35,35,400,316,0,0
maksssksksss261.png,without_mask,136,25,166,46,30,21,400,316,0,0
maksssksksss262.png,with_mask,151,179,260,316,109,137,400,301,0,0
maksssksksss263.png,without_mask,50,167,87,207,37,40,278,400,0,0
maksssksksss263.png,with_mask,164,124,216,185,52,61,278,400,0,0
maksssksksss263.png,with_mask,305,122,362,187,57,65,278,400,0,0
maksssksksss264.png,with_mask,21,54,90,119,69,65,267,400,0,0
maksssksksss264.png,with_mask,165,18,194,47,29,29,267,400,0,0
maksssksksss264.png,with_mask,145,89,195,139,50,50,267,400,0,0
maksssksksss264.png,with_mask,110,218,233,267,123,49,267,400,0,0
maksssksksss264.png,with_mask,275,88,320,136,45,48,267,400,0,0
maksssksksss264.png,with_mask,244,18,274,48,30,30,267,400,0,0
maksssksksss264.png,with_mask,338,12,374,48,36,36,267,400,0,0
maksssksksss265.png,with_mask,234,79,266,116,32,37,267,400,0,0
maksssksksss265.png,with_mask,338,66,368,99,30,33,267,400,0,0
maksssksksss265.png,with_mask,119,88,149,126,30,38,267,400,0,0
maksssksksss265.png,with_mask,146,98,166,122,20,24,267,400,0,0
maksssksksss265.png,with_mask,77,92,100,124,23,32,267,400,0,0
maksssksksss265.png,with_mask,2,108,31,141,29,33,267,400,0,0
maksssksksss266.png,with_mask,74,205,180,330,106,125,400,301,0,0
maksssksksss267.png,with_mask,161,23,185,45,24,22,267,400,0,0
maksssksksss267.png,with_mask,225,18,247,42,22,24,267,400,0,0
maksssksksss267.png,with_mask,197,75,216,100,19,25,267,400,0,0
maksssksksss267.png,with_mask,272,114,295,138,23,24,267,400,0,0
maksssksksss268.png,with_mask,73,76,148,137,75,61,400,225,0,0
maksssksksss268.png,without_mask,187,60,225,117,38,57,400,225,0,0
maksssksksss268.png,without_mask,48,95,77,122,29,27,400,225,0,0
maksssksksss268.png,with_mask,10,71,33,92,23,21,400,225,0,0
maksssksksss269.png,with_mask,78,80,229,236,151,156,295,400,0,0
maksssksksss269.png,with_mask,266,96,374,212,108,116,295,400,0,0
maksssksksss27.png,with_mask,163,88,251,185,88,97,312,400,0,0
maksssksksss270.png,with_mask,69,86,103,119,34,33,208,400,0,0
maksssksksss270.png,with_mask,171,85,208,123,37,38,208,400,0,0
maksssksksss270.png,with_mask,250,33,287,70,37,37,208,400,0,0
maksssksksss270.png,without_mask,105,69,126,91,21,22,208,400,0,0
maksssksksss270.png,without_mask,214,79,228,97,14,18,208,400,0,0
maksssksksss271.png,with_mask,89,177,212,333,123,156,400,301,0,0
maksssksksss272.png,mask_weared_incorrect,48,107,218,304,170,197,400,275,0,0
maksssksksss273.png,with_mask,81,143,187,277,106,134,400,301,0,0
maksssksksss274.png,with_mask,230,70,306,151,76,81,265,400,0,0
maksssksksss275.png,with_mask,56,241,145,334,89,93,400,335,0,0
maksssksksss276.png,mask_weared_incorrect,122,38,222,160,100,122,400,323,0,0
maksssksksss276.png,without_mask,274,112,310,153,36,41,400,323,0,0
maksssksksss277.png,with_mask,29,47,50,61,21,14,225,400,0,0
maksssksksss277.png,with_mask,96,39,114,54,18,15,225,400,0,0
maksssksksss277.png,with_mask,130,51,141,62,11,11,225,400,0,0
maksssksksss277.png,with_mask,163,45,178,63,15,18,225,400,0,0
maksssksksss277.png,with_mask,205,49,221,68,16,19,225,400,0,0
maksssksksss277.png,with_mask,280,50,291,69,11,19,225,400,0,0
maksssksksss277.png,with_mask,338,47,353,64,15,17,225,400,0,0
maksssksksss278.png,with_mask,295,75,334,115,39,40,300,400,0,0
maksssksksss278.png,with_mask,198,91,223,116,25,25,300,400,0,0
maksssksksss278.png,with_mask,225,65,248,90,23,25,300,400,0,0
maksssksksss278.png,with_mask,119,85,149,115,30,30,300,400,0,0
maksssksksss279.png,with_mask,290,80,341,135,51,55,266,400,0,0
maksssksksss279.png,without_mask,48,237,79,266,31,29,266,400,0,0
maksssksksss279.png,without_mask,117,248,147,266,30,18,266,400,0,0
maksssksksss28.png,with_mask,105,23,170,96,65,73,300,400,0,0
maksssksksss280.png,with_mask,25,54,43,72,18,18,267,400,0,0
maksssksksss280.png,with_mask,69,25,82,38,13,13,267,400,0,0
maksssksksss280.png,with_mask,94,68,111,84,17,16,267,400,0,0
maksssksksss280.png,with_mask,142,18,155,30,13,12,267,400,0,0
maksssksksss280.png,with_mask,158,31,174,48,16,17,267,400,0,0
maksssksksss280.png,with_mask,197,84,218,107,21,23,267,400,0,0
maksssksksss280.png,with_mask,175,15,190,30,15,15,267,400,0,0
maksssksksss280.png,with_mask,201,18,215,32,14,14,267,400,0,0
maksssksksss280.png,with_mask,239,62,257,81,18,19,267,400,0,0
maksssksksss280.png,with_mask,236,49,250,63,14,14,267,400,0,0
maksssksksss280.png,with_mask,260,31,273,42,13,11,267,400,0,0
maksssksksss280.png,with_mask,294,9,306,22,12,13,267,400,0,0
maksssksksss280.png,with_mask,376,21,388,33,12,12,267,400,0,0
maksssksksss281.png,with_mask,98,204,195,329,97,125,400,301,0,0
maksssksksss282.png,with_mask,175,55,215,93,40,38,267,400,0,0
maksssksksss282.png,with_mask,8,169,73,251,65,82,267,400,0,0
maksssksksss282.png,with_mask,127,185,178,235,51,50,267,400,0,0
maksssksksss282.png,with_mask,265,185,290,226,25,41,267,400,0,0
maksssksksss282.png,with_mask,320,199,366,260,46,61,267,400,0,0
maksssksksss282.png,with_mask,265,159,280,177,15,18,267,400,0,0
maksssksksss282.png,with_mask,325,143,342,155,17,12,267,400,0,0
maksssksksss282.png,mask_weared_incorrect,329,169,350,193,21,24,267,400,0,0
maksssksksss283.png,with_mask,77,206,170,323,93,117,400,301,0,0
maksssksksss284.png,with_mask,57,25,76,44,19,19,226,400,0,0
maksssksksss284.png,with_mask,110,2,127,20,17,18,226,400,0,0
maksssksksss284.png,with_mask,81,57,100,80,19,23,226,400,0,0
maksssksksss284.png,with_mask,131,22,153,46,22,24,226,400,0,0
maksssksksss284.png,with_mask,151,1,164,14,13,13,226,400,0,0
maksssksksss284.png,with_mask,188,6,202,21,14,15,226,400,0,0
maksssksksss284.png,with_mask,313,26,375,96,62,70,226,400,0,0
maksssksksss285.png,with_mask,66,99,209,235,143,136,267,400,0,0
maksssksksss286.png,with_mask,76,72,113,110,37,38,300,400,0,0
maksssksksss286.png,with_mask,236,94,274,134,38,40,300,400,0,0
maksssksksss287.png,with_mask,35,106,162,245,127,139,400,400,0,0
maksssksksss287.png,with_mask,248,135,361,254,113,119,400,400,0,0
maksssksksss288.png,with_mask,28,201,52,216,24,15,225,400,0,0
maksssksksss288.png,with_mask,143,93,175,126,32,33,225,400,0,0
maksssksksss288.png,with_mask,198,97,229,125,31,28,225,400,0,0
maksssksksss289.png,without_mask,89,193,149,258,60,65,400,267,0,0
maksssksksss289.png,without_mask,249,300,267,349,18,49,400,267,0,0
maksssksksss29.png,with_mask,50,96,120,171,70,75,295,400,0,0
maksssksksss29.png,mask_weared_incorrect,223,81,285,159,62,78,295,400,0,0
maksssksksss29.png,mask_weared_incorrect,279,44,340,114,61,70,295,400,0,0
maksssksksss290.png,with_mask,314,63,338,92,24,29,268,400,0,0
maksssksksss290.png,with_mask,184,42,213,72,29,30,268,400,0,0
maksssksksss290.png,with_mask,275,65,296,91,21,26,268,400,0,0
maksssksksss290.png,with_mask,256,82,277,95,21,13,268,400,0,0
maksssksksss290.png,with_mask,89,87,118,116,29,29,268,400,0,0
maksssksksss290.png,with_mask,133,89,154,113,21,24,268,400,0,0
maksssksksss291.png,with_mask,136,259,200,359,64,100,400,301,0,0
maksssksksss292.png,with_mask,189,88,220,125,31,37,300,400,0,0
maksssksksss292.png,with_mask,144,65,178,109,34,44,300,400,0,0
maksssksksss293.png,with_mask,5,102,51,163,46,61,289,400,0,0
maksssksksss293.png,with_mask,143,129,199,183,56,54,289,400,0,0
maksssksksss293.png,with_mask,267,66,318,117,51,51,289,400,0,0
maksssksksss293.png,with_mask,70,73,125,126,55,53,289,400,0,0
maksssksksss294.png,with_mask,63,59,77,82,14,23,241,400,0,0
maksssksksss294.png,with_mask,131,81,151,102,20,21,241,400,0,0
maksssksksss294.png,with_mask,202,78,223,100,21,22,241,400,0,0
maksssksksss294.png,with_mask,293,72,315,95,22,23,241,400,0,0
maksssksksss294.png,with_mask,343,71,354,99,11,28,241,400,0,0
maksssksksss295.png,with_mask,92,76,168,162,76,86,400,267,0,0
maksssksksss296.png,without_mask,42,88,68,112,26,24,226,400,0,0
maksssksksss296.png,without_mask,46,59,69,78,23,19,226,400,0,0
maksssksksss296.png,with_mask,77,56,97,72,20,16,226,400,0,0
maksssksksss296.png,without_mask,101,69,120,87,19,18,226,400,0,0
maksssksksss296.png,with_mask,114,51,132,70,18,19,226,400,0,0
maksssksksss296.png,without_mask,84,34,105,56,21,22,226,400,0,0
maksssksksss296.png,with_mask,42,125,62,158,20,33,226,400,0,0
maksssksksss296.png,without_mask,63,138,93,171,30,33,226,400,0,0
maksssksksss296.png,without_mask,91,162,121,197,30,35,226,400,0,0
maksssksksss296.png,with_mask,129,176,168,218,39,42,226,400,0,0
maksssksksss296.png,with_mask,136,102,162,131,26,29,226,400,0,0
maksssksksss296.png,with_mask,136,69,161,89,25,20,226,400,0,0
maksssksksss296.png,without_mask,140,33,155,48,15,15,226,400,0,0
maksssksksss296.png,with_mask,177,32,194,54,17,22,226,400,0,0
maksssksksss296.png,with_mask,172,46,184,65,12,19,226,400,0,0
maksssksksss296.png,with_mask,196,33,213,52,17,19,226,400,0,0
maksssksksss296.png,without_mask,221,22,237,40,16,18,226,400,0,0
maksssksksss296.png,without_mask,236,35,261,60,25,25,226,400,0,0
maksssksksss296.png,with_mask,175,90,197,114,22,24,226,400,0,0
maksssksksss296.png,with_mask,170,130,196,153,26,23,226,400,0,0
maksssksksss296.png,with_mask,213,101,238,130,25,29,226,400,0,0
maksssksksss296.png,without_mask,185,169,202,193,17,24,226,400,0,0
maksssksksss296.png,without_mask,165,172,182,207,17,35,226,400,0,0
maksssksksss296.png,with_mask,229,186,265,223,36,37,226,400,0,0
maksssksksss296.png,with_mask,244,113,272,141,28,28,226,400,0,0
maksssksksss296.png,with_mask,271,161,292,195,21,34,226,400,0,0
maksssksksss296.png,with_mask,262,82,282,103,20,21,226,400,0,0
maksssksksss296.png,with_mask,292,107,315,132,23,25,226,400,0,0
maksssksksss296.png,without_mask,262,18,282,38,20,20,226,400,0,0
maksssksksss296.png,without_mask,263,48,279,62,16,14,226,400,0,0
maksssksksss296.png,without_mask,282,26,300,43,18,17,226,400,0,0
maksssksksss296.png,with_mask,321,18,335,36,14,18,226,400,0,0
maksssksksss296.png,without_mask,296,49,314,67,18,18,226,400,0,0
maksssksksss296.png,with_mask,322,106,350,124,28,18,226,400,0,0
maksssksksss296.png,without_mask,341,154,373,182,32,28,226,400,0,0
maksssksksss297.png,with_mask,87,26,103,41,16,15,221,400,0,0
maksssksksss297.png,with_mask,50,125,82,156,32,31,221,400,0,0
maksssksksss297.png,with_mask,123,102,148,130,25,28,221,400,0,0
maksssksksss297.png,with_mask,157,57,179,82,22,25,221,400,0,0
maksssksksss297.png,with_mask,217,13,229,24,12,11,221,400,0,0
maksssksksss297.png,with_mask,207,44,228,68,21,24,221,400,0,0
maksssksksss297.png,with_mask,216,81,241,108,25,27,221,400,0,0
maksssksksss297.png,with_mask,250,43,273,67,23,24,221,400,0,0
maksssksksss297.png,without_mask,294,22,306,35,12,13,221,400,0,0
maksssksksss297.png,with_mask,318,27,332,44,14,17,221,400,0,0
maksssksksss297.png,with_mask,310,5,321,17,11,12,221,400,0,0
maksssksksss297.png,with_mask,334,3,348,16,14,13,221,400,0,0
maksssksksss298.png,with_mask,124,114,209,212,85,98,282,400,0,0
maksssksksss298.png,with_mask,248,52,324,140,76,88,282,400,0,0
maksssksksss299.png,without_mask,62,194,160,320,98,126,400,301,0,0
maksssksksss3.png,with_mask,52,53,73,76,21,23,271,400,0,0
maksssksksss3.png,with_mask,72,53,92,75,20,22,271,400,0,0
maksssksksss3.png,with_mask,155,60,177,83,22,23,271,400,0,0
maksssksksss3.png,with_mask,189,59,210,80,21,21,271,400,0,0
maksssksksss3.png,with_mask,235,57,257,78,22,21,271,400,0,0
maksssksksss3.png,with_mask,289,60,309,83,20,23,271,400,0,0
maksssksksss3.png,with_mask,313,68,333,90,20,22,271,400,0,0
maksssksksss3.png,with_mask,351,35,364,59,13,24,271,400,0,0
maksssksksss30.png,with_mask,56,41,94,81,38,40,242,400,0,0
maksssksksss30.png,without_mask,119,61,146,87,27,26,242,400,0,0
maksssksksss30.png,with_mask,166,59,196,83,30,24,242,400,0,0
maksssksksss30.png,with_mask,220,31,249,64,29,33,242,400,0,0
maksssksksss30.png,with_mask,262,66,290,95,28,29,242,400,0,0
maksssksksss30.png,without_mask,292,58,318,86,26,28,242,400,0,0
maksssksksss30.png,with_mask,334,131,365,161,31,30,242,400,0,0
maksssksksss300.png,with_mask,82,159,180,272,98,113,400,301,0,0
maksssksksss301.png,with_mask,146,43,174,72,28,29,225,400,0,0
maksssksksss301.png,with_mask,205,77,228,102,23,25,225,400,0,0
maksssksksss301.png,with_mask,90,176,143,225,53,49,225,400,0,0
maksssksksss301.png,with_mask,191,196,240,225,49,29,225,400,0,0
maksssksksss301.png,with_mask,325,34,348,58,23,24,225,400,0,0
maksssksksss301.png,with_mask,246,24,272,47,26,23,225,400,0,0
maksssksksss301.png,with_mask,279,22,303,51,24,29,225,400,0,0
maksssksksss301.png,with_mask,193,43,219,72,26,29,225,400,0,0
maksssksksss301.png,with_mask,155,11,173,30,18,19,225,400,0,0
maksssksksss301.png,with_mask,103,1,115,15,12,14,225,400,0,0
maksssksksss301.png,with_mask,55,12,73,29,18,17,225,400,0,0
maksssksksss301.png,with_mask,11,21,31,36,20,15,225,400,0,0
maksssksksss301.png,with_mask,77,6,89,20,12,14,225,400,0,0
maksssksksss301.png,with_mask,308,1,324,19,16,18,225,400,0,0
maksssksksss301.png,without_mask,85,19,100,37,15,18,225,400,0,0
maksssksksss302.png,with_mask,199,124,242,169,43,45,226,400,0,0
maksssksksss302.png,with_mask,149,28,190,84,41,56,226,400,0,0
maksssksksss302.png,without_mask,266,52,278,69,12,17,226,400,0,0
maksssksksss303.png,with_mask,92,66,110,81,18,15,225,400,0,0
maksssksksss303.png,with_mask,239,40,256,58,17,18,225,400,0,0
maksssksksss304.png,with_mask,202,61,246,103,44,42,282,400,0,0
maksssksksss304.png,with_mask,190,115,224,150,34,35,282,400,0,0
maksssksksss305.png,with_mask,207,120,223,135,16,15,300,400,0,0
maksssksksss305.png,with_mask,306,139,321,152,15,13,300,400,0,0
maksssksksss305.png,without_mask,343,141,359,155,16,14,300,400,0,0
maksssksksss305.png,without_mask,280,128,295,141,15,13,300,400,0,0
maksssksksss305.png,without_mask,256,118,270,130,14,12,300,400,0,0
maksssksksss305.png,without_mask,182,118,195,133,13,15,300,400,0,0
maksssksksss305.png,without_mask,139,116,155,130,16,14,300,400,0,0
maksssksksss305.png,without_mask,171,113,184,125,13,12,300,400,0,0
maksssksksss305.png,mask_weared_incorrect,72,114,89,129,17,15,300,400,0,0
maksssksksss305.png,mask_weared_incorrect,107,114,120,129,13,15,300,400,0,0
maksssksksss305.png,mask_weared_incorrect,94,161,107,175,13,14,300,400,0,0
maksssksksss305.png,mask_weared_incorrect,239,122,255,137,16,15,300,400,0,0
maksssksksss306.png,with_mask,143,181,254,321,111,140,400,301,0,0
maksssksksss307.png,mask_weared_incorrect,3,65,96,163,93,98,226,400,0,0
maksssksksss307.png,with_mask,146,28,249,140,103,112,226,400,0,0
maksssksksss307.png,without_mask,287,180,343,225,56,45,226,400,0,0
maksssksksss308.png,with_mask,209,64,232,84,23,20,200,400,0,0
maksssksksss308.png,with_mask,238,53,261,77,23,24,200,400,0,0
maksssksksss308.png,with_mask,270,77,286,96,16,19,200,400,0,0
maksssksksss309.png,mask_weared_incorrect,109,50,172,114,63,64,400,267,0,0
maksssksksss31.png,with_mask,209,90,278,165,69,75,267,400,0,0
maksssksksss31.png,with_mask,144,60,202,135,58,75,267,400,0,0
maksssksksss310.png,with_mask,21,32,44,59,23,27,267,400,0,0
maksssksksss310.png,with_mask,63,37,85,60,22,23,267,400,0,0
maksssksksss310.png,with_mask,228,28,248,50,20,22,267,400,0,0
maksssksksss310.png,with_mask,248,78,268,100,20,22,267,400,0,0
maksssksksss310.png,with_mask,333,51,348,70,15,19,267,400,0,0
maksssksksss311.png,with_mask,176,38,222,92,46,54,258,400,0,0
maksssksksss311.png,with_mask,222,57,252,84,30,27,258,400,0,0
maksssksksss311.png,with_mask,300,32,326,57,26,25,258,400,0,0
maksssksksss311.png,with_mask,31,34,63,61,32,27,258,400,0,0
maksssksksss311.png,with_mask,77,47,107,68,30,21,258,400,0,0
maksssksksss312.png,with_mask,49,124,72,149,23,25,400,300,0,0
maksssksksss312.png,with_mask,157,169,182,194,25,25,400,300,0,0
maksssksksss312.png,with_mask,188,112,217,140,29,28,400,300,0,0
maksssksksss313.png,with_mask,143,39,309,257,166,218,400,400,0,0
maksssksksss314.png,with_mask,1,33,38,89,37,56,267,400,0,0
maksssksksss314.png,with_mask,59,38,93,83,34,45,267,400,0,0
maksssksksss314.png,with_mask,169,61,201,102,32,41,267,400,0,0
maksssksksss314.png,with_mask,348,57,380,95,32,38,267,400,0,0
maksssksksss314.png,with_mask,214,112,236,130,22,18,267,400,0,0
maksssksksss314.png,with_mask,301,133,320,152,19,19,267,400,0,0
maksssksksss314.png,with_mask,325,133,346,156,21,23,267,400,0,0
maksssksksss314.png,with_mask,251,137,272,156,21,19,267,400,0,0
maksssksksss314.png,with_mask,236,125,255,145,19,20,267,400,0,0
maksssksksss315.png,with_mask,124,110,184,173,60,63,267,400,0,0
maksssksksss315.png,with_mask,272,117,320,163,48,46,267,400,0,0
maksssksksss316.png,without_mask,157,82,179,113,22,31,315,400,0,0
maksssksksss316.png,with_mask,91,38,133,78,42,40,315,400,0,0
maksssksksss316.png,with_mask,241,63,281,105,40,42,315,400,0,0
maksssksksss316.png,with_mask,312,67,332,110,20,43,315,400,0,0
maksssksksss317.png,with_mask,67,53,164,174,97,121,240,400,0,0
maksssksksss317.png,without_mask,283,25,326,69,43,44,240,400,0,0
maksssksksss318.png,with_mask,315,59,337,88,22,29,226,400,0,0
maksssksksss318.png,with_mask,212,52,240,80,28,28,226,400,0,0
maksssksksss318.png,without_mask,136,59,159,86,23,27,226,400,0,0
maksssksksss318.png,without_mask,50,82,66,99,16,17,226,400,0,0
maksssksksss318.png,without_mask,96,55,107,71,11,16,226,400,0,0
maksssksksss318.png,without_mask,32,61,47,76,15,15,226,400,0,0
maksssksksss318.png,without_mask,172,77,184,89,12,12,226,400,0,0
maksssksksss319.png,without_mask,131,66,143,79,12,13,250,400,0,0
maksssksksss319.png,with_mask,148,75,164,92,16,17,250,400,0,0
maksssksksss319.png,with_mask,182,60,200,82,18,22,250,400,0,0
maksssksksss319.png,with_mask,209,68,225,87,16,19,250,400,0,0
maksssksksss319.png,with_mask,234,79,249,95,15,16,250,400,0,0
maksssksksss319.png,with_mask,285,82,302,99,17,17,250,400,0,0
maksssksksss32.png,with_mask,177,46,200,70,23,24,225,400,0,0
maksssksksss32.png,with_mask,305,32,338,60,33,28,225,400,0,0
maksssksksss320.png,with_mask,107,21,126,44,19,23,230,400,0,0
maksssksksss320.png,with_mask,185,89,201,108,16,19,230,400,0,0
maksssksksss320.png,with_mask,335,10,357,36,22,26,230,400,0,0
maksssksksss321.png,without_mask,170,82,212,145,42,63,208,400,0,0
maksssksksss321.png,with_mask,215,70,281,151,66,81,208,400,0,0
maksssksksss322.png,with_mask,60,100,186,253,126,153,400,301,0,0
maksssksksss323.png,with_mask,322,257,368,346,46,89,376,400,0,0
maksssksksss324.png,with_mask,90,123,224,277,134,154,400,339,0,0
maksssksksss325.png,with_mask,177,58,208,91,31,33,267,400,0,0
maksssksksss325.png,with_mask,26,113,44,130,18,17,267,400,0,0
maksssksksss325.png,with_mask,57,130,72,143,15,13,267,400,0,0
maksssksksss325.png,with_mask,117,133,129,147,12,14,267,400,0,0
maksssksksss325.png,with_mask,250,138,261,150,11,12,267,400,0,0
maksssksksss325.png,with_mask,302,101,317,121,15,20,267,400,0,0
maksssksksss325.png,with_mask,333,108,347,127,14,19,267,400,0,0
maksssksksss325.png,with_mask,359,66,383,99,24,33,267,400,0,0
maksssksksss326.png,with_mask,164,77,230,152,66,75,400,382,0,0
maksssksksss326.png,with_mask,192,116,276,183,84,67,400,382,0,0
maksssksksss327.png,without_mask,18,84,64,134,46,50,279,400,0,0
maksssksksss327.png,without_mask,18,200,69,246,51,46,279,400,0,0
maksssksksss327.png,without_mask,112,46,149,73,37,27,279,400,0,0
maksssksksss327.png,with_mask,237,137,290,186,53,49,279,400,0,0
maksssksksss327.png,without_mask,278,17,322,66,44,49,279,400,0,0
maksssksksss327.png,without_mask,342,98,385,140,43,42,279,400,0,0
maksssksksss327.png,without_mask,346,218,393,254,47,36,279,400,0,0
maksssksksss328.png,with_mask,82,139,187,270,105,131,400,301,0,0
maksssksksss329.png,with_mask,44,25,95,81,51,56,267,400,0,0
maksssksksss329.png,with_mask,50,121,89,158,39,37,267,400,0,0
maksssksksss329.png,with_mask,41,210,88,260,47,50,267,400,0,0
maksssksksss329.png,with_mask,176,29,228,85,52,56,267,400,0,0
maksssksksss329.png,with_mask,175,123,225,169,50,46,267,400,0,0
maksssksksss329.png,with_mask,177,212,227,259,50,47,267,400,0,0
maksssksksss329.png,with_mask,312,28,360,81,48,53,267,400,0,0
maksssksksss329.png,with_mask,302,118,346,169,44,51,267,400,0,0
maksssksksss329.png,with_mask,288,182,368,264,80,82,267,400,0,0
maksssksksss33.png,with_mask,114,47,143,75,29,28,400,250,0,0
maksssksksss330.png,with_mask,24,79,56,107,32,28,300,400,0,0
maksssksksss330.png,with_mask,92,44,125,79,33,35,300,400,0,0
maksssksksss330.png,with_mask,166,65,203,100,37,35,300,400,0,0
maksssksksss330.png,with_mask,284,39,343,98,59,59,300,400,0,0
maksssksksss331.png,with_mask,25,69,48,93,23,24,267,400,0,0
maksssksksss331.png,mask_weared_incorrect,88,87,107,106,19,19,267,400,0,0
maksssksksss331.png,with_mask,128,61,149,84,21,23,267,400,0,0
maksssksksss331.png,with_mask,127,157,168,209,41,52,267,400,0,0
maksssksksss331.png,with_mask,147,110,181,145,34,35,267,400,0,0
maksssksksss331.png,with_mask,208,61,220,77,12,16,267,400,0,0
maksssksksss331.png,with_mask,229,96,265,137,36,41,267,400,0,0
maksssksksss331.png,mask_weared_incorrect,263,46,277,65,14,19,267,400,0,0
maksssksksss331.png,with_mask,270,72,288,92,18,20,267,400,0,0
maksssksksss331.png,with_mask,298,108,321,133,23,25,267,400,0,0
maksssksksss331.png,with_mask,308,65,328,86,20,21,267,400,0,0
maksssksksss331.png,with_mask,334,119,381,163,47,44,267,400,0,0
maksssksksss331.png,with_mask,365,49,380,65,15,16,267,400,0,0
maksssksksss331.png,with_mask,342,49,358,67,16,18,267,400,0,0
maksssksksss331.png,with_mask,1,148,23,179,22,31,267,400,0,0
maksssksksss332.png,with_mask,62,213,166,319,104,106,400,301,0,0
maksssksksss333.png,with_mask,76,203,181,330,105,127,400,301,0,0
maksssksksss334.png,with_mask,96,74,136,127,40,53,312,400,0,0
maksssksksss334.png,with_mask,193,100,234,146,41,46,312,400,0,0
maksssksksss334.png,with_mask,259,105,305,151,46,46,312,400,0,0
maksssksksss334.png,without_mask,334,106,367,144,33,38,312,400,0,0
maksssksksss335.png,with_mask,12,153,125,293,113,140,400,301,0,0
maksssksksss336.png,with_mask,123,67,143,83,20,16,267,400,0,0
maksssksksss336.png,with_mask,167,114,183,128,16,14,267,400,0,0
maksssksksss336.png,with_mask,225,60,240,76,15,16,267,400,0,0
maksssksksss336.png,with_mask,261,65,277,82,16,17,267,400,0,0
maksssksksss336.png,without_mask,282,75,295,92,13,17,267,400,0,0
maksssksksss336.png,with_mask,330,20,362,56,32,36,267,400,0,0
maksssksksss337.png,with_mask,115,32,145,70,30,38,400,246,0,0
maksssksksss338.png,with_mask,48,33,81,71,33,38,250,400,0,0
maksssksksss338.png,with_mask,158,86,182,108,24,22,250,400,0,0
maksssksksss338.png,with_mask,203,51,228,82,25,31,250,400,0,0
maksssksksss338.png,with_mask,298,34,325,64,27,30,250,400,0,0
maksssksksss338.png,with_mask,38,200,56,228,18,28,250,400,0,0
maksssksksss339.png,with_mask,89,210,180,303,91,93,400,400,0,0
maksssksksss34.png,with_mask,63,99,75,113,12,14,267,400,0,0
maksssksksss34.png,with_mask,102,79,117,95,15,16,267,400,0,0
maksssksksss34.png,with_mask,142,84,155,99,13,15,267,400,0,0
maksssksksss34.png,with_mask,195,79,209,95,14,16,267,400,0,0
maksssksksss34.png,with_mask,213,86,228,103,15,17,267,400,0,0
maksssksksss34.png,with_mask,245,71,260,86,15,15,267,400,0,0
maksssksksss34.png,without_mask,299,91,312,104,13,13,267,400,0,0
maksssksksss340.png,with_mask,59,1,105,55,46,54,400,600,0,0
maksssksksss340.png,without_mask,133,83,195,140,62,57,400,600,0,0
maksssksksss340.png,with_mask,243,85,308,147,65,62,400,600,0,0
maksssksksss340.png,with_mask,458,68,527,157,69,89,400,600,0,0
maksssksksss341.png,with_mask,67,197,160,318,93,121,400,301,0,0
maksssksksss342.png,without_mask,28,53,54,81,26,28,258,400,0,0
maksssksksss342.png,with_mask,86,46,103,64,17,18,258,400,0,0
maksssksksss342.png,with_mask,103,49,116,62,13,13,258,400,0,0
maksssksksss342.png,with_mask,130,42,144,58,14,16,258,400,0,0
maksssksksss342.png,with_mask,72,93,99,120,27,27,258,400,0,0
maksssksksss342.png,with_mask,106,116,145,158,39,42,258,400,0,0
maksssksksss342.png,with_mask,160,56,173,70,13,14,258,400,0,0
maksssksksss342.png,with_mask,184,64,203,91,19,27,258,400,0,0
maksssksksss342.png,with_mask,213,47,226,66,13,19,258,400,0,0
maksssksksss342.png,with_mask,252,95,287,130,35,35,258,400,0,0
maksssksksss342.png,with_mask,320,192,385,255,65,63,258,400,0,0
maksssksksss342.png,with_mask,297,62,320,85,23,23,258,400,0,0
maksssksksss343.png,without_mask,85,131,232,284,147,153,400,301,0,0
maksssksksss344.png,with_mask,96,14,110,27,14,13,226,400,0,0
maksssksksss344.png,with_mask,236,25,261,50,25,25,226,400,0,0
maksssksksss344.png,with_mask,318,94,342,115,24,21,226,400,0,0
maksssksksss345.png,with_mask,186,110,218,142,32,32,267,400,0,0
maksssksksss345.png,without_mask,148,109,182,136,34,27,267,400,0,0
maksssksksss346.png,with_mask,54,18,141,108,87,90,374,400,0,0
maksssksksss346.png,with_mask,272,26,386,158,114,132,374,400,0,0
maksssksksss346.png,with_mask,100,254,149,325,49,71,374,400,0,0
maksssksksss346.png,with_mask,246,251,349,354,103,103,374,400,0,0
maksssksksss347.png,without_mask,8,147,57,198,49,51,400,267,0,0
maksssksksss347.png,with_mask,102,90,175,156,73,66,400,267,0,0
maksssksksss347.png,without_mask,211,128,267,233,56,105,400,267,0,0
maksssksksss348.png,without_mask,86,189,188,304,102,115,400,301,0,0
maksssksksss349.png,with_mask,156,54,254,163,98,109,268,400,0,0
maksssksksss349.png,with_mask,35,170,90,223,55,53,268,400,0,0
maksssksksss349.png,without_mask,234,17,294,96,60,79,268,400,0,0
maksssksksss35.png,with_mask,132,44,208,123,76,79,255,400,0,0
maksssksksss35.png,with_mask,330,67,375,114,45,47,255,400,0,0
maksssksksss350.png,with_mask,112,64,133,86,21,22,267,400,0,0
maksssksksss350.png,with_mask,271,32,298,58,27,26,267,400,0,0
maksssksksss351.png,with_mask,143,67,257,195,114,128,238,400,0,0
maksssksksss352.png,with_mask,144,68,190,110,46,42,400,250,0,0
maksssksksss352.png,without_mask,48,90,91,133,43,43,400,250,0,0
maksssksksss353.png,with_mask,227,70,265,111,38,41,267,400,0,0
maksssksksss354.png,with_mask,4,162,33,194,29,32,300,400,0,0
maksssksksss354.png,with_mask,27,121,41,138,14,17,300,400,0,0
maksssksksss354.png,with_mask,72,123,86,136,14,13,300,400,0,0
maksssksksss354.png,with_mask,94,135,136,185,42,50,300,400,0,0
maksssksksss354.png,with_mask,170,129,185,145,15,16,300,400,0,0
maksssksksss354.png,with_mask,206,121,229,147,23,26,300,400,0,0
maksssksksss354.png,with_mask,321,125,340,145,19,20,300,400,0,0
maksssksksss355.png,with_mask,103,231,181,338,78,107,400,301,0,0
maksssksksss356.png,with_mask,113,178,218,302,105,124,400,301,0,0
maksssksksss357.png,with_mask,219,35,263,85,44,50,235,400,0,0
maksssksksss358.png,with_mask,91,64,126,106,35,42,300,400,0,0
maksssksksss358.png,with_mask,179,65,221,109,42,44,300,400,0,0
maksssksksss358.png,with_mask,268,82,300,115,32,33,300,400,0,0
maksssksksss358.png,with_mask,300,86,341,125,41,39,300,400,0,0
maksssksksss359.png,with_mask,23,40,44,61,21,21,226,400,0,0
maksssksksss359.png,with_mask,59,54,76,73,17,19,226,400,0,0
maksssksksss359.png,with_mask,114,35,126,49,12,14,226,400,0,0
maksssksksss359.png,with_mask,130,47,152,71,22,24,226,400,0,0
maksssksksss359.png,with_mask,140,35,154,49,14,14,226,400,0,0
maksssksksss359.png,with_mask,155,44,171,63,16,19,226,400,0,0
maksssksksss359.png,with_mask,169,96,191,117,22,21,226,400,0,0
maksssksksss359.png,with_mask,185,45,197,59,12,14,226,400,0,0
maksssksksss359.png,with_mask,206,42,218,59,12,17,226,400,0,0
maksssksksss359.png,with_mask,217,43,234,63,17,20,226,400,0,0
maksssksksss359.png,with_mask,238,52,253,68,15,16,226,400,0,0
maksssksksss359.png,with_mask,252,59,271,79,19,20,226,400,0,0
maksssksksss359.png,with_mask,274,62,296,84,22,22,226,400,0,0
maksssksksss359.png,with_mask,298,39,314,57,16,18,226,400,0,0
maksssksksss359.png,without_mask,316,42,331,55,15,13,226,400,0,0
maksssksksss359.png,with_mask,345,33,362,53,17,20,226,400,0,0
maksssksksss359.png,with_mask,368,38,385,59,17,21,226,400,0,0
maksssksksss36.png,with_mask,24,24,47,52,23,28,225,400,0,0
maksssksksss36.png,with_mask,111,38,127,56,16,18,225,400,0,0
maksssksksss36.png,with_mask,145,39,170,67,25,28,225,400,0,0
maksssksksss36.png,with_mask,195,22,216,46,21,24,225,400,0,0
maksssksksss36.png,with_mask,323,46,337,61,14,15,225,400,0,0
maksssksksss36.png,with_mask,336,31,354,49,18,18,225,400,0,0
maksssksksss36.png,with_mask,354,25,379,50,25,25,225,400,0,0
maksssksksss360.png,with_mask,173,33,206,71,33,38,265,400,0,0
maksssksksss361.png,without_mask,37,60,60,88,23,28,250,400,0,0
maksssksksss361.png,with_mask,194,71,230,107,36,36,250,400,0,0
maksssksksss361.png,without_mask,329,25,352,52,23,27,250,400,0,0
maksssksksss362.png,with_mask,61,117,167,222,106,105,275,400,0,0
maksssksksss362.png,with_mask,175,127,258,214,83,87,275,400,0,0
maksssksksss362.png,with_mask,258,90,338,180,80,90,275,400,0,0
maksssksksss363.png,with_mask,79,48,97,69,18,21,197,400,0,0
maksssksksss363.png,with_mask,116,78,134,101,18,23,197,400,0,0
maksssksksss363.png,with_mask,161,79,179,96,18,17,197,400,0,0
maksssksksss363.png,with_mask,193,53,209,76,16,23,197,400,0,0
maksssksksss363.png,with_mask,327,24,361,64,34,40,197,400,0,0
maksssksksss363.png,with_mask,345,87,379,128,34,41,197,400,0,0
maksssksksss364.png,with_mask,83,56,117,95,34,39,267,400,0,0
maksssksksss364.png,with_mask,179,51,212,87,33,36,267,400,0,0
maksssksksss364.png,with_mask,263,62,295,101,32,39,267,400,0,0
maksssksksss365.png,with_mask,129,118,171,167,42,49,240,400,0,0
maksssksksss365.png,with_mask,208,123,243,155,35,32,240,400,0,0
maksssksksss365.png,without_mask,266,125,281,151,15,26,240,400,0,0
maksssksksss366.png,with_mask,48,44,184,205,136,161,306,512,0,0
maksssksksss366.png,with_mask,379,61,480,205,101,144,306,512,0,0
maksssksksss367.png,with_mask,241,60,271,97,30,37,267,400,0,0
maksssksksss368.png,with_mask,354,36,375,64,21,28,267,400,0,0
maksssksksss368.png,with_mask,314,23,339,53,25,30,267,400,0,0
maksssksksss368.png,with_mask,253,35,278,61,25,26,267,400,0,0
maksssksksss368.png,with_mask,195,54,212,77,17,23,267,400,0,0
maksssksksss368.png,with_mask,175,57,191,75,16,18,267,400,0,0
maksssksksss368.png,with_mask,104,48,127,70,23,22,267,400,0,0
maksssksksss368.png,with_mask,41,69,64,93,23,24,267,400,0,0
maksssksksss368.png,with_mask,62,65,80,88,18,23,267,400,0,0
maksssksksss368.png,with_mask,16,51,30,64,14,13,267,400,0,0
maksssksksss369.png,with_mask,123,139,217,267,94,128,400,301,0,0
maksssksksss37.png,with_mask,78,110,192,265,114,155,400,301,0,0
maksssksksss370.png,without_mask,135,135,241,263,106,128,400,301,0,0
maksssksksss371.png,mask_weared_incorrect,160,37,263,154,103,117,225,400,0,0
maksssksksss372.png,with_mask,95,33,116,59,21,26,209,400,0,0
maksssksksss372.png,with_mask,165,19,186,43,21,24,209,400,0,0
maksssksksss373.png,with_mask,20,54,65,105,45,51,340,512,0,0
maksssksksss373.png,with_mask,50,99,122,167,72,68,340,512,0,0
maksssksksss373.png,with_mask,188,107,225,141,37,34,340,512,0,0
maksssksksss373.png,with_mask,207,59,241,87,34,28,340,512,0,0
maksssksksss373.png,with_mask,220,81,250,118,30,37,340,512,0,0
maksssksksss373.png,with_mask,244,63,303,118,59,55,340,512,0,0
maksssksksss373.png,with_mask,330,73,365,107,35,34,340,512,0,0
maksssksksss373.png,without_mask,320,31,344,55,24,24,340,512,0,0
maksssksksss373.png,without_mask,367,57,391,82,24,25,340,512,0,0
maksssksksss373.png,with_mask,398,74,434,114,36,40,340,512,0,0
maksssksksss373.png,with_mask,426,125,483,177,57,52,340,512,0,0
maksssksksss373.png,with_mask,440,69,468,96,28,27,340,512,0,0
maksssksksss373.png,with_mask,427,29,454,54,27,25,340,512,0,0
maksssksksss374.png,with_mask,183,21,215,51,32,30,240,400,0,0
maksssksksss374.png,with_mask,28,91,52,113,24,22,240,400,0,0
maksssksksss374.png,with_mask,191,143,225,182,34,39,240,400,0,0
maksssksksss374.png,without_mask,314,30,345,61,31,31,240,400,0,0
maksssksksss374.png,with_mask,92,64,123,89,31,25,240,400,0,0
maksssksksss375.png,without_mask,259,76,277,94,18,18,310,400,0,0
maksssksksss375.png,without_mask,273,192,289,210,16,18,310,400,0,0
maksssksksss376.png,with_mask,58,48,94,88,36,40,221,400,0,0
maksssksksss376.png,with_mask,191,29,210,51,19,22,221,400,0,0
maksssksksss376.png,with_mask,229,15,242,31,13,16,221,400,0,0
maksssksksss376.png,with_mask,318,77,330,94,12,17,221,400,0,0
maksssksksss376.png,with_mask,338,72,349,84,11,12,221,400,0,0
maksssksksss376.png,with_mask,350,79,377,102,27,23,221,400,0,0
maksssksksss377.png,with_mask,132,75,246,176,114,101,300,400,0,0
maksssksksss378.png,with_mask,112,90,158,132,46,42,188,400,0,0
maksssksksss378.png,with_mask,237,61,285,103,48,42,188,400,0,0
maksssksksss379.png,without_mask,129,197,212,317,83,120,400,301,0,0
maksssksksss38.png,with_mask,194,102,230,139,36,37,285,400,0,0
maksssksksss38.png,without_mask,252,116,284,149,32,33,285,400,0,0
maksssksksss380.png,with_mask,47,210,157,359,110,149,400,301,0,0
maksssksksss381.png,with_mask,97,64,120,89,23,25,311,400,0,0
maksssksksss381.png,with_mask,163,75,185,95,22,20,311,400,0,0
maksssksksss381.png,with_mask,207,70,229,96,22,26,311,400,0,0
maksssksksss381.png,with_mask,247,73,267,96,20,23,311,400,0,0
maksssksksss382.png,with_mask,324,89,340,111,16,22,300,400,0,0
maksssksksss382.png,with_mask,256,111,274,128,18,17,300,400,0,0
maksssksksss382.png,with_mask,195,96,215,114,20,18,300,400,0,0
maksssksksss382.png,with_mask,139,105,158,126,19,21,300,400,0,0
maksssksksss382.png,with_mask,64,95,82,121,18,26,300,400,0,0
maksssksksss383.png,with_mask,90,183,190,309,100,126,400,301,0,0
maksssksksss384.png,with_mask,37,244,50,258,13,14,400,267,0,0
maksssksksss384.png,with_mask,146,238,161,255,15,17,400,267,0,0
maksssksksss384.png,with_mask,221,237,238,254,17,17,400,267,0,0
maksssksksss385.png,with_mask,125,76,157,113,32,37,245,400,0,0
maksssksksss385.png,without_mask,385,25,396,46,11,21,245,400,0,0
maksssksksss385.png,without_mask,217,27,229,41,12,14,245,400,0,0
maksssksksss386.png,mask_weared_incorrect,83,43,110,75,27,32,268,400,0,0
maksssksksss386.png,with_mask,139,65,167,94,28,29,268,400,0,0
maksssksksss386.png,with_mask,185,70,204,89,19,19,268,400,0,0
maksssksksss386.png,with_mask,228,67,248,88,20,21,268,400,0,0
maksssksksss386.png,with_mask,249,76,262,90,13,14,268,400,0,0
maksssksksss386.png,with_mask,262,68,273,81,11,13,268,400,0,0
maksssksksss387.png,with_mask,209,73,247,113,38,40,226,400,0,0
maksssksksss387.png,mask_weared_incorrect,287,60,328,115,41,55,226,400,0,0
maksssksksss387.png,with_mask,354,109,400,191,46,82,226,400,0,0
maksssksksss387.png,without_mask,156,20,173,37,17,17,226,400,0,0
maksssksksss388.png,with_mask,26,92,44,121,18,29,225,400,0,0
maksssksksss388.png,with_mask,106,88,122,111,16,23,225,400,0,0
maksssksksss388.png,with_mask,122,102,146,124,24,22,225,400,0,0
maksssksksss388.png,with_mask,151,73,168,94,17,21,225,400,0,0
maksssksksss388.png,without_mask,168,76,190,100,22,24,225,400,0,0
maksssksksss388.png,with_mask,188,96,219,131,31,35,225,400,0,0
maksssksksss388.png,without_mask,192,59,210,78,18,19,225,400,0,0
maksssksksss388.png,without_mask,223,53,243,76,20,23,225,400,0,0
maksssksksss388.png,without_mask,272,67,291,88,19,21,225,400,0,0
maksssksksss388.png,with_mask,260,93,279,115,19,22,225,400,0,0
maksssksksss388.png,with_mask,288,86,308,113,20,27,225,400,0,0
maksssksksss388.png,with_mask,348,71,366,91,18,20,225,400,0,0
maksssksksss388.png,mask_weared_incorrect,303,96,330,123,27,27,225,400,0,0
maksssksksss388.png,without_mask,371,77,396,100,25,23,225,400,0,0
maksssksksss388.png,without_mask,68,75,80,88,12,13,225,400,0,0
maksssksksss388.png,without_mask,321,70,333,84,12,14,225,400,0,0
maksssksksss388.png,with_mask,367,67,378,79,11,12,225,400,0,0
maksssksksss389.png,with_mask,123,148,188,217,65,69,300,400,0,0
maksssksksss389.png,with_mask,1,231,57,295,56,64,300,400,0,0
maksssksksss389.png,with_mask,15,67,62,116,47,49,300,400,0,0
maksssksksss389.png,with_mask,114,74,159,116,45,42,300,400,0,0
maksssksksss389.png,with_mask,236,80,293,135,57,55,300,400,0,0
maksssksksss389.png,with_mask,191,30,233,78,42,48,300,400,0,0
maksssksksss389.png,with_mask,279,10,317,52,38,42,300,400,0,0
maksssksksss389.png,with_mask,1,84,21,117,20,33,300,400,0,0
maksssksksss389.png,with_mask,330,18,368,53,38,35,300,400,0,0
maksssksksss389.png,with_mask,246,13,273,47,27,34,300,400,0,0
maksssksksss389.png,without_mask,163,44,191,75,28,31,300,400,0,0
maksssksksss389.png,without_mask,339,59,393,111,54,52,300,400,0,0
maksssksksss39.png,with_mask,157,107,223,184,66,77,400,398,0,0
maksssksksss39.png,with_mask,239,97,347,219,108,122,400,398,0,0
maksssksksss390.png,with_mask,51,131,81,159,30,28,300,400,0,0
maksssksksss390.png,with_mask,96,130,126,158,30,28,300,400,0,0
maksssksksss390.png,with_mask,197,126,219,150,22,24,300,400,0,0
maksssksksss390.png,with_mask,281,137,305,157,24,20,300,400,0,0
maksssksksss390.png,with_mask,315,130,332,147,17,17,300,400,0,0
maksssksksss390.png,with_mask,387,114,400,131,13,17,300,400,0,0
maksssksksss391.png,with_mask,93,34,119,61,26,27,270,400,0,0
maksssksksss391.png,with_mask,174,62,199,92,25,30,270,400,0,0
maksssksksss391.png,with_mask,234,91,262,118,28,27,270,400,0,0
maksssksksss391.png,with_mask,305,77,336,108,31,31,270,400,0,0
maksssksksss392.png,with_mask,168,76,292,211,124,135,277,400,0,0
maksssksksss393.png,with_mask,44,88,161,206,117,118,400,400,0,0
maksssksksss393.png,with_mask,241,261,365,390,124,129,400,400,0,0
maksssksksss394.png,with_mask,142,13,249,133,107,120,218,400,0,0
maksssksksss395.png,with_mask,218,57,307,164,89,107,267,400,0,0
maksssksksss396.png,with_mask,24,118,55,151,31,33,300,400,0,0
maksssksksss396.png,with_mask,83,140,116,176,33,36,300,400,0,0
maksssksksss396.png,with_mask,167,97,210,142,43,45,300,400,0,0
maksssksksss396.png,with_mask,269,142,291,165,22,23,300,400,0,0
maksssksksss396.png,without_mask,310,86,366,135,56,49,300,400,0,0
maksssksksss397.png,with_mask,40,43,82,91,42,48,225,400,0,0
maksssksksss397.png,with_mask,181,58,252,128,71,70,225,400,0,0
maksssksksss397.png,with_mask,303,49,358,107,55,58,225,400,0,0
maksssksksss398.png,with_mask,153,122,251,223,98,101,336,400,0,0
maksssksksss399.png,with_mask,305,93,334,135,29,42,267,400,0,0
maksssksksss399.png,with_mask,324,84,351,111,27,27,267,400,0,0
maksssksksss399.png,with_mask,191,98,228,134,37,36,267,400,0,0
maksssksksss399.png,with_mask,155,60,183,96,28,36,267,400,0,0
maksssksksss399.png,with_mask,106,70,129,98,23,28,267,400,0,0
maksssksksss399.png,with_mask,51,54,81,90,30,36,267,400,0,0
maksssksksss399.png,with_mask,236,54,275,87,39,33,267,400,0,0
maksssksksss399.png,without_mask,267,56,298,91,31,35,267,400,0,0
maksssksksss4.png,with_mask,70,185,176,321,106,136,400,301,0,0
maksssksksss40.png,with_mask,65,87,106,134,41,47,267,400,0,0
maksssksksss40.png,with_mask,203,75,232,114,29,39,267,400,0,0
maksssksksss40.png,with_mask,258,77,297,123,39,46,267,400,0,0
maksssksksss40.png,without_mask,367,80,394,112,27,32,267,400,0,0
maksssksksss400.png,with_mask,87,117,136,171,49,54,225,400,0,0
maksssksksss400.png,with_mask,165,95,214,148,49,53,225,400,0,0
maksssksksss400.png,with_mask,281,84,331,135,50,51,225,400,0,0
maksssksksss401.png,without_mask,101,49,134,91,33,42,280,400,0,0
maksssksksss401.png,without_mask,133,75,166,111,33,36,280,400,0,0
maksssksksss401.png,with_mask,228,102,263,148,35,46,280,400,0,0
maksssksksss401.png,with_mask,346,62,367,101,21,39,280,400,0,0
maksssksksss402.png,without_mask,90,256,165,349,75,93,400,301,0,0
maksssksksss403.png,with_mask,96,226,199,350,103,124,400,301,0,0
maksssksksss404.png,without_mask,112,214,183,319,71,105,400,301,0,0
maksssksksss405.png,with_mask,101,264,182,370,81,106,400,301,0,0
maksssksksss406.png,mask_weared_incorrect,171,69,239,144,68,75,210,400,0,0
maksssksksss407.png,with_mask,102,204,202,331,100,127,400,301,0,0
maksssksksss408.png,with_mask,1,66,26,94,25,28,225,400,0,0
maksssksksss408.png,with_mask,19,46,44,73,25,27,225,400,0,0
maksssksksss408.png,without_mask,76,38,104,61,28,23,225,400,0,0
maksssksksss408.png,with_mask,129,37,148,55,19,18,225,400,0,0
maksssksksss408.png,with_mask,154,34,182,52,28,18,225,400,0,0
maksssksksss408.png,with_mask,151,64,180,89,29,25,225,400,0,0
maksssksksss408.png,with_mask,51,64,94,106,43,42,225,400,0,0
maksssksksss408.png,with_mask,195,64,228,92,33,28,225,400,0,0
maksssksksss408.png,with_mask,309,77,344,112,35,35,225,400,0,0
maksssksksss408.png,without_mask,256,45,283,69,27,24,225,400,0,0
maksssksksss409.png,with_mask,91,208,172,320,81,112,400,301,0,0
maksssksksss41.png,with_mask,29,184,63,216,34,32,281,400,0,0
maksssksksss41.png,with_mask,50,165,74,194,24,29,281,400,0,0
maksssksksss41.png,with_mask,107,175,139,208,32,33,281,400,0,0
maksssksksss41.png,with_mask,181,151,201,172,20,21,281,400,0,0
maksssksksss41.png,with_mask,202,188,236,225,34,37,281,400,0,0
maksssksksss41.png,with_mask,234,183,247,207,13,24,281,400,0,0
maksssksksss41.png,with_mask,253,169,271,189,18,20,281,400,0,0
maksssksksss41.png,with_mask,283,203,315,235,32,32,281,400,0,0
maksssksksss41.png,with_mask,337,186,361,210,24,24,281,400,0,0
maksssksksss410.png,with_mask,34,153,62,176,28,23,267,400,0,0
maksssksksss410.png,with_mask,88,138,111,163,23,25,267,400,0,0
maksssksksss410.png,with_mask,139,207,168,234,29,27,267,400,0,0
maksssksksss410.png,with_mask,116,135,135,154,19,19,267,400,0,0
maksssksksss410.png,with_mask,135,103,152,121,17,18,267,400,0,0
maksssksksss410.png,mask_weared_incorrect,101,91,115,106,14,15,267,400,0,0
maksssksksss410.png,with_mask,58,109,72,127,14,18,267,400,0,0
maksssksksss410.png,with_mask,176,115,202,139,26,24,267,400,0,0
maksssksksss410.png,with_mask,205,96,221,115,16,19,267,400,0,0
maksssksksss410.png,with_mask,291,110,324,139,33,29,267,400,0,0
maksssksksss410.png,with_mask,366,131,381,154,15,23,267,400,0,0
maksssksksss410.png,with_mask,217,62,231,78,14,16,267,400,0,0
maksssksksss410.png,with_mask,180,56,192,68,12,12,267,400,0,0
maksssksksss410.png,with_mask,55,60,67,74,12,14,267,400,0,0
maksssksksss411.png,with_mask,21,98,43,120,22,22,267,400,0,0
maksssksksss411.png,without_mask,84,81,111,114,27,33,267,400,0,0
maksssksksss411.png,with_mask,142,101,174,141,32,40,267,400,0,0
maksssksksss411.png,with_mask,191,91,217,117,26,26,267,400,0,0
maksssksksss411.png,with_mask,226,63,260,100,34,37,267,400,0,0
maksssksksss411.png,with_mask,299,85,313,104,14,19,267,400,0,0
maksssksksss411.png,with_mask,321,60,353,95,32,35,267,400,0,0
maksssksksss411.png,with_mask,370,94,396,122,26,28,267,400,0,0
maksssksksss412.png,with_mask,190,100,267,186,77,86,400,400,0,0
maksssksksss412.png,with_mask,317,198,391,274,74,76,400,400,0,0
maksssksksss413.png,with_mask,71,53,104,88,33,35,210,400,0,0
maksssksksss413.png,with_mask,174,32,204,70,30,38,210,400,0,0
maksssksksss413.png,with_mask,291,80,340,134,49,54,210,400,0,0
maksssksksss414.png,with_mask,119,81,147,117,28,36,225,400,0,0
maksssksksss414.png,with_mask,103,42,123,60,20,18,225,400,0,0
maksssksksss414.png,with_mask,203,23,226,48,23,25,225,400,0,0
maksssksksss414.png,with_mask,314,15,342,46,28,31,225,400,0,0
maksssksksss415.png,with_mask,86,127,179,234,93,107,400,301,0,0
maksssksksss416.png,with_mask,130,20,149,39,19,19,226,400,0,0
maksssksksss416.png,with_mask,173,82,196,102,23,20,226,400,0,0
maksssksksss416.png,with_mask,276,77,295,99,19,22,226,400,0,0
maksssksksss416.png,with_mask,300,93,318,120,18,27,226,400,0,0
maksssksksss417.png,with_mask,115,200,217,338,102,138,400,301,0,0
maksssksksss418.png,with_mask,340,146,353,159,13,13,225,400,0,0
maksssksksss419.png,with_mask,128,46,151,77,23,31,400,267,0,0
maksssksksss419.png,without_mask,7,156,19,177,12,21,400,267,0,0
maksssksksss419.png,without_mask,20,163,38,183,18,20,400,267,0,0
maksssksksss419.png,without_mask,37,151,50,169,13,18,400,267,0,0
maksssksksss42.png,with_mask,36,73,95,141,59,68,353,400,0,0
maksssksksss42.png,with_mask,175,67,228,133,53,66,353,400,0,0
maksssksksss42.png,with_mask,304,67,363,135,59,68,353,400,0,0
maksssksksss42.png,with_mask,33,244,95,312,62,68,353,400,0,0
maksssksksss42.png,with_mask,170,248,231,321,61,73,353,400,0,0
maksssksksss42.png,with_mask,306,248,366,313,60,65,353,400,0,0
maksssksksss420.png,without_mask,96,171,197,282,101,111,400,301,0,0
maksssksksss421.png,with_mask,65,78,97,114,32,36,267,400,0,0
maksssksksss421.png,with_mask,111,109,130,130,19,21,267,400,0,0
maksssksksss421.png,with_mask,182,41,221,83,39,42,267,400,0,0
maksssksksss421.png,with_mask,212,79,233,100,21,21,267,400,0,0
maksssksksss421.png,with_mask,302,53,341,94,39,41,267,400,0,0
maksssksksss422.png,with_mask,45,47,114,130,69,83,400,400,0,0
maksssksksss422.png,with_mask,224,247,350,372,126,125,400,400,0,0
maksssksksss423.png,with_mask,3,49,16,64,13,15,226,400,0,0
maksssksksss423.png,with_mask,42,11,66,40,24,29,226,400,0,0
maksssksksss423.png,mask_weared_incorrect,144,68,155,81,11,13,226,400,0,0
maksssksksss423.png,with_mask,157,24,170,45,13,21,226,400,0,0
maksssksksss423.png,with_mask,197,45,208,60,11,15,226,400,0,0
maksssksksss423.png,with_mask,256,44,270,60,14,16,226,400,0,0
maksssksksss423.png,with_mask,276,46,289,62,13,16,226,400,0,0
maksssksksss423.png,with_mask,320,48,335,64,15,16,226,400,0,0
maksssksksss423.png,with_mask,351,55,363,69,12,14,226,400,0,0
maksssksksss424.png,with_mask,31,186,48,205,17,19,267,400,0,0
maksssksksss424.png,with_mask,97,194,113,210,16,16,267,400,0,0
maksssksksss424.png,with_mask,135,150,149,163,14,13,267,400,0,0
maksssksksss424.png,without_mask,142,171,155,185,13,14,267,400,0,0
maksssksksss424.png,with_mask,122,181,137,194,15,13,267,400,0,0
maksssksksss424.png,with_mask,159,173,174,189,15,16,267,400,0,0
maksssksksss424.png,with_mask,176,159,190,176,14,17,267,400,0,0
maksssksksss424.png,with_mask,214,153,226,165,12,12,267,400,0,0
maksssksksss424.png,with_mask,194,179,210,196,16,17,267,400,0,0
maksssksksss424.png,with_mask,203,197,220,217,17,20,267,400,0,0
maksssksksss424.png,with_mask,233,148,248,164,15,16,267,400,0,0
maksssksksss424.png,without_mask,221,248,240,267,19,19,267,400,0,0
maksssksksss425.png,with_mask,203,122,349,266,146,144,400,400,0,0
maksssksksss426.png,with_mask,154,78,313,247,159,169,267,400,0,0
maksssksksss427.png,with_mask,120,61,182,129,62,68,210,400,0,0
maksssksksss427.png,with_mask,52,68,68,85,16,17,210,400,0,0
maksssksksss427.png,with_mask,216,64,238,86,22,22,210,400,0,0
maksssksksss427.png,with_mask,299,1,395,88,96,87,210,400,0,0
maksssksksss428.png,with_mask,34,153,63,175,29,22,267,400,0,0
maksssksksss428.png,with_mask,87,140,111,161,24,21,267,400,0,0
maksssksksss428.png,with_mask,116,133,135,153,19,20,267,400,0,0
maksssksksss428.png,with_mask,138,207,168,234,30,27,267,400,0,0
maksssksksss428.png,with_mask,177,115,203,138,26,23,267,400,0,0
maksssksksss428.png,with_mask,292,110,324,138,32,28,267,400,0,0
maksssksksss428.png,with_mask,366,133,382,153,16,20,267,400,0,0
maksssksksss428.png,with_mask,205,95,220,115,15,20,267,400,0,0
maksssksksss428.png,with_mask,218,63,232,78,14,15,267,400,0,0
maksssksksss428.png,with_mask,180,56,191,68,11,12,267,400,0,0
maksssksksss428.png,with_mask,58,110,72,128,14,18,267,400,0,0
maksssksksss428.png,mask_weared_incorrect,101,93,116,105,15,12,267,400,0,0
maksssksksss428.png,with_mask,134,105,151,120,17,15,267,400,0,0
maksssksksss429.png,with_mask,28,57,50,80,22,23,267,400,0,0
maksssksksss429.png,with_mask,102,112,124,133,22,21,267,400,0,0
maksssksksss429.png,with_mask,163,118,184,142,21,24,267,400,0,0
maksssksksss429.png,with_mask,251,212,267,236,16,24,267,400,0,0
maksssksksss43.png,with_mask,116,46,172,108,56,62,400,266,0,0
maksssksksss43.png,with_mask,7,121,31,147,24,26,400,266,0,0
maksssksksss430.png,with_mask,112,87,176,144,64,57,300,400,0,0
maksssksksss430.png,with_mask,220,73,294,133,74,60,300,400,0,0
maksssksksss431.png,mask_weared_incorrect,20,71,76,129,56,58,226,400,0,0
maksssksksss431.png,with_mask,150,114,197,171,47,57,226,400,0,0
maksssksksss431.png,with_mask,201,149,230,192,29,43,226,400,0,0
maksssksksss431.png,with_mask,241,153,291,205,50,52,226,400,0,0
maksssksksss431.png,with_mask,309,140,345,185,36,45,226,400,0,0
maksssksksss431.png,with_mask,250,67,275,99,25,32,226,400,0,0
maksssksksss431.png,with_mask,276,60,302,87,26,27,226,400,0,0
maksssksksss431.png,with_mask,196,48,214,72,18,24,226,400,0,0
maksssksksss431.png,with_mask,214,35,234,57,20,22,226,400,0,0
maksssksksss431.png,with_mask,178,65,204,87,26,22,226,400,0,0
maksssksksss431.png,with_mask,232,11,248,26,16,15,226,400,0,0
maksssksksss431.png,with_mask,266,6,281,19,15,13,226,400,0,0
maksssksksss431.png,with_mask,207,8,222,22,15,14,226,400,0,0
maksssksksss432.png,with_mask,181,75,247,148,66,73,243,400,0,0
maksssksksss433.png,with_mask,132,191,222,323,90,132,400,301,0,0
maksssksksss434.png,with_mask,138,155,325,339,187,184,400,400,0,0
maksssksksss435.png,with_mask,94,48,115,71,21,23,282,400,0,0
maksssksksss435.png,with_mask,85,164,106,182,21,18,282,400,0,0
maksssksksss435.png,with_mask,164,51,193,86,29,35,282,400,0,0
maksssksksss435.png,with_mask,229,25,267,72,38,47,282,400,0,0
maksssksksss435.png,with_mask,263,57,291,87,28,30,282,400,0,0
maksssksksss436.png,with_mask,79,174,126,226,47,52,400,300,0,0
maksssksksss436.png,with_mask,206,120,259,178,53,58,400,300,0,0
maksssksksss437.png,with_mask,82,43,113,89,31,46,267,400,0,0
maksssksksss437.png,with_mask,131,111,147,131,16,20,267,400,0,0
maksssksksss437.png,with_mask,205,109,232,139,27,30,267,400,0,0
maksssksksss437.png,with_mask,276,102,302,131,26,29,267,400,0,0
maksssksksss438.png,with_mask,78,22,92,36,14,14,225,400,0,0
maksssksksss438.png,with_mask,152,13,166,28,14,15,225,400,0,0
maksssksksss438.png,with_mask,233,32,246,46,13,14,225,400,0,0
maksssksksss438.png,with_mask,293,28,304,46,11,18,225,400,0,0
maksssksksss439.png,with_mask,192,120,224,155,32,35,267,400,0,0
maksssksksss439.png,with_mask,287,110,319,157,32,47,267,400,0,0
maksssksksss439.png,with_mask,134,126,151,146,17,20,267,400,0,0
maksssksksss439.png,with_mask,171,132,187,148,16,16,267,400,0,0
maksssksksss44.png,with_mask,43,139,80,182,37,43,226,400,0,0
maksssksksss44.png,with_mask,140,93,188,148,48,55,226,400,0,0
maksssksksss44.png,with_mask,261,47,321,120,60,73,226,400,0,0
maksssksksss44.png,without_mask,332,12,394,90,62,78,226,400,0,0
maksssksksss440.png,with_mask,81,25,102,47,21,22,225,400,0,0
maksssksksss440.png,mask_weared_incorrect,101,30,114,50,13,20,225,400,0,0
maksssksksss440.png,with_mask,122,48,134,62,12,14,225,400,0,0
maksssksksss440.png,with_mask,158,46,172,61,14,15,225,400,0,0
maksssksksss440.png,with_mask,184,49,216,77,32,28,225,400,0,0
maksssksksss440.png,with_mask,240,40,253,60,13,20,225,400,0,0
maksssksksss440.png,with_mask,303,29,323,52,20,23,225,400,0,0
maksssksksss440.png,mask_weared_incorrect,353,30,371,51,18,21,225,400,0,0
maksssksksss441.png,with_mask,17,156,67,206,50,50,266,400,0,0
maksssksksss441.png,with_mask,102,120,159,183,57,63,266,400,0,0
maksssksksss441.png,with_mask,206,117,267,185,61,68,266,400,0,0
maksssksksss442.png,without_mask,89,169,215,309,126,140,400,301,0,0
maksssksksss443.png,without_mask,89,155,187,264,98,109,400,301,0,0
maksssksksss444.png,without_mask,109,156,124,180,15,24,259,400,0,0
maksssksksss444.png,with_mask,242,146,282,184,40,38,259,400,0,0
maksssksksss444.png,with_mask,301,132,332,164,31,32,259,400,0,0
maksssksksss444.png,with_mask,346,159,383,196,37,37,259,400,0,0
maksssksksss445.png,with_mask,17,104,55,137,38,33,267,400,0,0
maksssksksss445.png,with_mask,52,78,86,111,34,33,267,400,0,0
maksssksksss445.png,mask_weared_incorrect,72,56,101,93,29,37,267,400,0,0
maksssksksss445.png,with_mask,142,73,177,108,35,35,267,400,0,0
maksssksksss445.png,with_mask,180,56,210,90,30,34,267,400,0,0
maksssksksss445.png,with_mask,240,68,264,96,24,28,267,400,0,0
maksssksksss445.png,with_mask,267,62,298,97,31,35,267,400,0,0
maksssksksss445.png,with_mask,332,34,350,61,18,27,267,400,0,0
maksssksksss445.png,with_mask,377,39,396,62,19,23,267,400,0,0
maksssksksss445.png,mask_weared_incorrect,199,237,230,266,31,29,267,400,0,0
maksssksksss446.png,with_mask,78,49,395,386,317,337,500,500,0,0
maksssksksss447.png,with_mask,108,60,127,79,19,19,267,400,0,0
maksssksksss447.png,with_mask,201,84,217,102,16,18,267,400,0,0
maksssksksss447.png,with_mask,313,74,331,97,18,23,267,400,0,0
maksssksksss448.png,with_mask,282,39,321,84,39,45,216,400,0,0
maksssksksss448.png,with_mask,230,34,264,69,34,35,216,400,0,0
maksssksksss448.png,with_mask,194,60,232,101,38,41,216,400,0,0
maksssksksss448.png,with_mask,99,50,150,99,51,49,216,400,0,0
maksssksksss449.png,with_mask,94,60,118,83,24,23,381,400,0,0
maksssksksss449.png,with_mask,124,72,147,93,23,21,381,400,0,0
maksssksksss449.png,with_mask,157,44,186,78,29,34,381,400,0,0
maksssksksss449.png,with_mask,265,242,295,276,30,34,381,400,0,0
maksssksksss45.png,without_mask,63,34,95,63,32,29,226,400,0,0
maksssksksss45.png,with_mask,222,40,272,84,50,44,226,400,0,0
maksssksksss45.png,without_mask,250,159,279,203,29,44,226,400,0,0
maksssksksss450.png,with_mask,65,100,101,137,36,37,283,400,0,0
maksssksksss450.png,with_mask,175,110,207,148,32,38,283,400,0,0
maksssksksss450.png,with_mask,208,67,240,102,32,35,283,400,0,0
maksssksksss450.png,with_mask,327,95,360,130,33,35,283,400,0,0
maksssksksss451.png,with_mask,11,1,33,13,22,12,273,400,0,0
maksssksksss451.png,with_mask,120,7,141,28,21,21,273,400,0,0
maksssksksss451.png,with_mask,93,36,114,59,21,23,273,400,0,0
maksssksksss451.png,without_mask,161,9,179,28,18,19,273,400,0,0
maksssksksss451.png,with_mask,126,37,152,67,26,30,273,400,0,0
maksssksksss451.png,with_mask,2,149,50,233,48,84,273,400,0,0
maksssksksss451.png,without_mask,230,48,244,67,14,19,273,400,0,0
maksssksksss451.png,without_mask,210,61,233,84,23,23,273,400,0,0
maksssksksss451.png,with_mask,184,99,213,131,29,32,273,400,0,0
maksssksksss451.png,with_mask,265,25,287,52,22,27,273,400,0,0
maksssksksss451.png,with_mask,323,43,341,66,18,23,273,400,0,0
maksssksksss451.png,with_mask,298,117,327,145,29,28,273,400,0,0
maksssksksss451.png,with_mask,363,86,386,108,23,22,273,400,0,0
maksssksksss452.png,with_mask,39,53,73,93,34,40,289,400,0,0
maksssksksss452.png,with_mask,129,66,156,96,27,30,289,400,0,0
maksssksksss452.png,with_mask,272,79,302,111,30,32,289,400,0,0
maksssksksss453.png,without_mask,2,56,16,74,14,18,300,400,0,0
maksssksksss453.png,without_mask,18,46,37,67,19,21,300,400,0,0
maksssksksss453.png,without_mask,46,46,59,62,13,16,300,400,0,0
maksssksksss453.png,without_mask,19,109,32,127,13,18,300,400,0,0
maksssksksss453.png,with_mask,26,140,49,169,23,29,300,400,0,0
maksssksksss453.png,mask_weared_incorrect,47,172,71,203,24,31,300,400,0,0
maksssksksss453.png,without_mask,97,273,131,300,34,27,300,400,0,0
maksssksksss453.png,without_mask,108,7,120,22,12,15,300,400,0,0
maksssksksss453.png,without_mask,111,39,127,60,16,21,300,400,0,0
maksssksksss453.png,without_mask,133,51,146,73,13,22,300,400,0,0
maksssksksss453.png,without_mask,147,55,159,77,12,22,300,400,0,0
maksssksksss453.png,without_mask,97,104,114,124,17,20,300,400,0,0
maksssksksss453.png,with_mask,124,148,143,175,19,27,300,400,0,0
maksssksksss453.png,with_mask,158,147,175,173,17,26,300,400,0,0
maksssksksss453.png,without_mask,193,54,206,71,13,17,300,400,0,0
maksssksksss453.png,without_mask,208,54,219,72,11,18,300,400,0,0
maksssksksss453.png,with_mask,229,64,241,93,12,29,300,400,0,0
maksssksksss453.png,without_mask,261,26,279,53,18,27,300,400,0,0
maksssksksss453.png,without_mask,296,39,310,58,14,19,300,400,0,0
maksssksksss453.png,with_mask,344,34,365,61,21,27,300,400,0,0
maksssksksss453.png,with_mask,339,77,359,111,20,34,300,400,0,0
maksssksksss453.png,without_mask,108,10,122,22,14,12,300,400,0,0
maksssksksss454.png,with_mask,143,97,255,211,112,114,278,400,0,0
maksssksksss455.png,without_mask,115,222,225,373,110,151,400,301,0,0
maksssksksss456.png,with_mask,171,70,232,141,61,71,300,400,0,0
maksssksksss457.png,with_mask,270,98,313,142,43,44,300,400,0,0
maksssksksss457.png,with_mask,189,60,228,100,39,40,300,400,0,0
maksssksksss457.png,with_mask,122,73,150,100,28,27,300,400,0,0
maksssksksss457.png,without_mask,6,68,41,109,35,41,300,400,0,0
maksssksksss457.png,with_mask,334,92,351,110,17,18,300,400,0,0
maksssksksss458.png,without_mask,22,110,47,136,25,26,267,400,0,0
maksssksksss458.png,with_mask,105,86,149,143,44,57,267,400,0,0
maksssksksss458.png,with_mask,146,118,182,159,36,41,267,400,0,0
maksssksksss459.png,with_mask,60,67,115,117,55,50,400,298,0,0
maksssksksss459.png,mask_weared_incorrect,185,77,239,134,54,57,400,298,0,0
maksssksksss46.png,with_mask,17,37,41,59,24,22,226,400,0,0
maksssksksss46.png,with_mask,68,21,87,38,19,17,226,400,0,0
maksssksksss46.png,with_mask,114,32,132,48,18,16,226,400,0,0
maksssksksss46.png,with_mask,147,31,170,53,23,22,226,400,0,0
maksssksksss46.png,with_mask,207,20,223,37,16,17,226,400,0,0
maksssksksss46.png,with_mask,238,27,251,43,13,16,226,400,0,0
maksssksksss46.png,with_mask,267,27,282,40,15,13,226,400,0,0
maksssksksss46.png,with_mask,287,22,302,39,15,17,226,400,0,0
maksssksksss46.png,with_mask,326,30,348,51,22,21,226,400,0,0
maksssksksss46.png,with_mask,357,27,375,45,18,18,226,400,0,0
maksssksksss460.png,without_mask,7,52,24,72,17,20,267,400,0,0
maksssksksss460.png,with_mask,26,58,53,94,27,36,267,400,0,0
maksssksksss460.png,with_mask,58,69,70,80,12,11,267,400,0,0
maksssksksss460.png,with_mask,111,50,133,76,22,26,267,400,0,0
maksssksksss460.png,with_mask,134,63,148,82,14,19,267,400,0,0
maksssksksss460.png,with_mask,206,69,221,88,15,19,267,400,0,0
maksssksksss460.png,without_mask,226,56,241,76,15,20,267,400,0,0
maksssksksss460.png,with_mask,243,75,260,95,17,20,267,400,0,0
maksssksksss460.png,with_mask,307,80,328,104,21,24,267,400,0,0
maksssksksss461.png,with_mask,218,185,263,229,45,44,268,400,0,0
maksssksksss461.png,with_mask,300,124,347,176,47,52,268,400,0,0
maksssksksss461.png,with_mask,368,135,395,196,27,61,268,400,0,0
maksssksksss461.png,with_mask,369,47,395,81,26,34,268,400,0,0
maksssksksss461.png,with_mask,244,117,281,159,37,42,268,400,0,0
maksssksksss461.png,with_mask,141,80,186,128,45,48,268,400,0,0
maksssksksss461.png,with_mask,92,72,125,109,33,37,268,400,0,0
maksssksksss461.png,with_mask,57,106,91,140,34,34,268,400,0,0
maksssksksss461.png,with_mask,21,95,45,121,24,26,268,400,0,0
maksssksksss462.png,with_mask,119,38,148,73,29,35,400,268,0,0
maksssksksss463.png,with_mask,136,101,258,226,122,125,400,365,0,0
maksssksksss464.png,with_mask,57,67,107,122,50,55,300,400,0,0
maksssksksss464.png,with_mask,188,111,218,146,30,35,300,400,0,0
maksssksksss464.png,with_mask,233,83,262,117,29,34,300,400,0,0
maksssksksss464.png,with_mask,268,187,290,216,22,29,300,400,0,0
maksssksksss465.png,with_mask,231,42,297,128,66,86,300,400,0,0
maksssksksss466.png,with_mask,11,89,53,149,42,60,267,400,0,0
maksssksksss466.png,with_mask,71,60,122,111,51,51,267,400,0,0
maksssksksss466.png,with_mask,142,117,197,167,55,50,267,400,0,0
maksssksksss466.png,with_mask,265,53,310,104,45,51,267,400,0,0
maksssksksss467.png,with_mask,56,89,98,127,42,38,290,400,0,0
maksssksksss467.png,with_mask,181,62,215,95,34,33,290,400,0,0
maksssksksss467.png,with_mask,291,61,318,91,27,30,290,400,0,0
maksssksksss467.png,with_mask,318,91,348,120,30,29,290,400,0,0
maksssksksss467.png,mask_weared_incorrect,261,73,278,96,17,23,290,400,0,0
maksssksksss467.png,without_mask,152,76,171,98,19,22,290,400,0,0
maksssksksss468.png,with_mask,100,144,215,273,115,129,400,301,0,0
maksssksksss469.png,with_mask,166,100,243,175,77,75,298,400,0,0
maksssksksss469.png,with_mask,254,125,315,172,61,47,298,400,0,0
maksssksksss47.png,with_mask,152,64,285,207,133,143,268,400,0,0
maksssksksss470.png,with_mask,52,28,100,75,48,47,200,400,0,0
maksssksksss470.png,with_mask,95,63,123,91,28,28,200,400,0,0
maksssksksss470.png,with_mask,151,58,188,101,37,43,200,400,0,0
maksssksksss470.png,with_mask,276,40,304,88,28,48,200,400,0,0
maksssksksss470.png,with_mask,344,56,377,90,33,34,200,400,0,0
maksssksksss471.png,with_mask,65,71,100,113,35,42,300,400,0,0
maksssksksss471.png,without_mask,134,61,153,88,19,27,300,400,0,0
maksssksksss471.png,without_mask,168,35,194,68,26,33,300,400,0,0
maksssksksss471.png,with_mask,363,52,386,75,23,23,300,400,0,0
maksssksksss471.png,with_mask,336,78,357,95,21,17,300,400,0,0
maksssksksss472.png,with_mask,220,68,256,117,36,49,300,400,0,0
maksssksksss473.png,without_mask,53,79,91,123,38,44,203,400,0,0
maksssksksss473.png,with_mask,110,49,144,83,34,34,203,400,0,0
maksssksksss473.png,with_mask,244,28,276,67,32,39,203,400,0,0
maksssksksss473.png,with_mask,300,75,332,112,32,37,203,400,0,0
maksssksksss474.png,with_mask,1,163,32,198,31,35,267,400,0,0
maksssksksss474.png,with_mask,49,159,76,183,27,24,267,400,0,0
maksssksksss474.png,with_mask,154,45,178,67,24,22,267,400,0,0
maksssksksss474.png,with_mask,238,21,260,47,22,26,267,400,0,0
maksssksksss475.png,with_mask,45,69,73,96,28,27,267,400,0,0
maksssksksss475.png,with_mask,109,80,134,109,25,29,267,400,0,0
maksssksksss475.png,with_mask,164,64,198,100,34,36,267,400,0,0
maksssksksss475.png,with_mask,243,96,267,127,24,31,267,400,0,0
maksssksksss475.png,without_mask,303,84,339,130,36,46,267,400,0,0
maksssksksss475.png,with_mask,350,67,372,105,22,38,267,400,0,0
maksssksksss476.png,with_mask,353,17,381,51,28,34,267,400,0,0
maksssksksss476.png,with_mask,210,40,238,68,28,28,267,400,0,0
maksssksksss476.png,with_mask,17,72,41,97,24,25,267,400,0,0
maksssksksss476.png,with_mask,105,61,129,86,24,25,267,400,0,0
maksssksksss476.png,with_mask,94,116,118,152,24,36,267,400,0,0
maksssksksss476.png,without_mask,286,52,309,76,23,24,267,400,0,0
maksssksksss476.png,without_mask,116,110,143,138,27,28,267,400,0,0
maksssksksss477.png,without_mask,36,15,52,33,16,18,267,400,0,0
maksssksksss477.png,without_mask,62,49,81,67,19,18,267,400,0,0
maksssksksss477.png,without_mask,57,90,78,111,21,21,267,400,0,0
maksssksksss477.png,with_mask,45,138,65,157,20,19,267,400,0,0
maksssksksss477.png,without_mask,181,32,198,50,17,18,267,400,0,0
maksssksksss477.png,with_mask,162,73,182,91,20,18,267,400,0,0
maksssksksss477.png,with_mask,179,99,198,117,19,18,267,400,0,0
maksssksksss477.png,with_mask,168,144,189,165,21,21,267,400,0,0
maksssksksss477.png,with_mask,288,9,306,26,18,17,267,400,0,0
maksssksksss477.png,with_mask,319,36,339,53,20,17,267,400,0,0
maksssksksss477.png,without_mask,315,71,332,85,17,14,267,400,0,0
maksssksksss477.png,without_mask,273,105,291,124,18,19,267,400,0,0
maksssksksss477.png,with_mask,308,162,328,173,20,11,267,400,0,0
maksssksksss478.png,with_mask,36,102,157,243,121,141,400,400,0,0
maksssksksss478.png,with_mask,246,134,362,250,116,116,400,400,0,0
maksssksksss479.png,with_mask,116,156,225,302,109,146,400,301,0,0
maksssksksss48.png,without_mask,85,152,190,279,105,127,400,301,0,0
maksssksksss480.png,with_mask,133,189,243,341,110,152,400,301,0,0
maksssksksss481.png,with_mask,13,87,35,108,22,21,267,400,0,0
maksssksksss481.png,with_mask,39,92,65,118,26,26,267,400,0,0
maksssksksss481.png,with_mask,98,98,117,117,19,19,267,400,0,0
maksssksksss481.png,with_mask,208,67,235,97,27,30,267,400,0,0
maksssksksss481.png,with_mask,160,88,172,102,12,14,267,400,0,0
maksssksksss482.png,without_mask,40,246,135,364,95,118,400,301,0,0
maksssksksss483.png,with_mask,115,47,157,87,42,40,267,400,0,0
maksssksksss483.png,with_mask,186,90,231,130,45,40,267,400,0,0
maksssksksss483.png,with_mask,307,42,347,84,40,42,267,400,0,0
maksssksksss483.png,without_mask,69,64,89,81,20,17,267,400,0,0
maksssksksss484.png,mask_weared_incorrect,82,52,141,115,59,63,400,267,0,0
maksssksksss485.png,with_mask,142,280,225,387,83,107,400,301,0,0
maksssksksss486.png,with_mask,142,70,164,92,22,22,217,400,0,0
maksssksksss486.png,with_mask,192,90,212,109,20,19,217,400,0,0
maksssksksss486.png,with_mask,259,99,274,112,15,13,217,400,0,0
maksssksksss487.png,without_mask,2,104,47,156,45,52,267,400,0,0
maksssksksss487.png,with_mask,51,61,121,133,70,72,267,400,0,0
maksssksksss487.png,with_mask,159,79,218,140,59,61,267,400,0,0
maksssksksss487.png,with_mask,215,81,270,139,55,58,267,400,0,0
maksssksksss487.png,with_mask,288,58,349,119,61,61,267,400,0,0
maksssksksss488.png,with_mask,188,51,211,76,23,25,267,400,0,0
maksssksksss488.png,with_mask,41,54,64,78,23,24,267,400,0,0
maksssksksss489.png,with_mask,46,37,66,55,20,18,211,400,0,0
maksssksksss489.png,without_mask,129,51,158,70,29,19,211,400,0,0
maksssksksss489.png,without_mask,192,52,203,64,11,12,211,400,0,0
maksssksksss489.png,without_mask,290,46,317,64,27,18,211,400,0,0
maksssksksss489.png,without_mask,342,41,363,58,21,17,211,400,0,0
maksssksksss489.png,without_mask,373,41,387,52,14,11,211,400,0,0
maksssksksss49.png,with_mask,352,102,370,123,18,21,225,400,0,0
maksssksksss49.png,with_mask,272,33,289,51,17,18,225,400,0,0
maksssksksss49.png,with_mask,188,124,206,143,18,19,225,400,0,0
maksssksksss49.png,with_mask,20,54,41,72,21,18,225,400,0,0
maksssksksss49.png,with_mask,123,68,141,87,18,19,225,400,0,0
maksssksksss49.png,with_mask,157,45,173,63,16,18,225,400,0,0
maksssksksss49.png,without_mask,95,211,113,225,18,14,225,400,0,0
maksssksksss49.png,without_mask,225,181,240,200,15,19,225,400,0,0
maksssksksss490.png,with_mask,85,149,212,280,127,131,400,301,0,0
maksssksksss491.png,with_mask,125,132,220,264,95,132,400,301,0,0
maksssksksss492.png,with_mask,60,154,161,278,101,124,400,301,0,0
maksssksksss493.png,with_mask,62,165,182,315,120,150,400,301,0,0
maksssksksss494.png,with_mask,91,80,163,158,72,78,400,267,0,0
maksssksksss495.png,without_mask,1,47,26,97,25,50,225,400,0,0
maksssksksss495.png,mask_weared_incorrect,77,24,134,98,57,74,225,400,0,0
maksssksksss495.png,with_mask,99,174,168,224,69,50,225,400,0,0
maksssksksss495.png,without_mask,170,64,224,125,54,61,225,400,0,0
maksssksksss495.png,with_mask,224,70,267,121,43,51,225,400,0,0
maksssksksss495.png,without_mask,274,61,330,122,56,61,225,400,0,0
maksssksksss495.png,with_mask,291,189,356,224,65,35,225,400,0,0
maksssksksss495.png,with_mask,329,117,388,181,59,64,225,400,0,0
maksssksksss495.png,without_mask,351,53,389,92,38,39,225,400,0,0
maksssksksss496.png,mask_weared_incorrect,85,97,184,207,99,110,400,267,0,0
maksssksksss497.png,with_mask,111,226,194,331,83,105,400,301,0,0
maksssksksss498.png,with_mask,92,46,112,67,20,21,272,400,0,0
maksssksksss498.png,with_mask,151,59,163,72,12,13,272,400,0,0
maksssksksss498.png,without_mask,166,53,179,67,13,14,272,400,0,0
maksssksksss498.png,mask_weared_incorrect,194,57,207,74,13,17,272,400,0,0
maksssksksss498.png,with_mask,251,72,264,89,13,17,272,400,0,0
maksssksksss498.png,with_mask,292,69,306,89,14,20,272,400,0,0
maksssksksss498.png,without_mask,321,56,340,77,19,21,272,400,0,0
maksssksksss498.png,with_mask,355,67,375,90,20,23,272,400,0,0
maksssksksss499.png,without_mask,101,24,132,62,31,38,226,400,0,0
maksssksksss499.png,with_mask,222,44,253,77,31,33,226,400,0,0
maksssksksss5.png,with_mask,118,54,161,96,43,42,266,400,0,0
maksssksksss5.png,without_mask,192,106,229,144,37,38,266,400,0,0
maksssksksss5.png,with_mask,249,95,291,139,42,44,266,400,0,0
maksssksksss50.png,with_mask,206,83,238,114,32,31,292,400,0,0
maksssksksss50.png,with_mask,226,51,262,82,36,31,292,400,0,0
maksssksksss500.png,with_mask,113,230,216,368,103,138,400,301,0,0
maksssksksss501.png,with_mask,1,41,43,125,42,84,255,400,0,0
maksssksksss501.png,with_mask,48,39,118,124,70,85,255,400,0,0
maksssksksss501.png,with_mask,162,47,221,123,59,76,255,400,0,0
maksssksksss501.png,with_mask,242,30,298,105,56,75,255,400,0,0
maksssksksss501.png,with_mask,301,51,351,118,50,67,255,400,0,0
maksssksksss502.png,without_mask,55,72,115,136,60,64,225,400,0,0
maksssksksss502.png,with_mask,112,85,155,136,43,51,225,400,0,0
maksssksksss502.png,without_mask,181,56,243,126,62,70,225,400,0,0
maksssksksss502.png,with_mask,347,107,398,167,51,60,225,400,0,0
maksssksksss503.png,with_mask,196,141,240,182,44,41,289,400,0,0
maksssksksss503.png,with_mask,245,68,294,122,49,54,289,400,0,0
maksssksksss504.png,with_mask,31,170,135,296,104,126,400,301,0,0
maksssksksss505.png,with_mask,60,107,170,218,110,111,400,267,0,0
maksssksksss506.png,with_mask,79,79,272,269,193,190,500,500,0,0
maksssksksss507.png,with_mask,131,55,250,175,119,120,200,400,0,0
maksssksksss508.png,with_mask,69,96,146,173,77,77,240,400,0,0
maksssksksss508.png,with_mask,196,38,254,103,58,65,240,400,0,0
maksssksksss508.png,with_mask,253,90,319,164,66,74,240,400,0,0
maksssksksss508.png,with_mask,326,77,363,121,37,44,240,400,0,0
maksssksksss509.png,with_mask,151,1,242,57,91,56,225,400,0,0
maksssksksss51.png,without_mask,114,159,213,286,99,127,400,301,0,0
maksssksksss510.png,with_mask,27,32,93,101,66,69,267,400,0,0
maksssksksss510.png,with_mask,165,86,189,111,24,25,267,400,0,0
maksssksksss510.png,with_mask,231,89,259,127,28,38,267,400,0,0
maksssksksss510.png,with_mask,288,90,329,123,41,33,267,400,0,0
maksssksksss511.png,with_mask,152,100,241,182,89,82,294,400,0,0
maksssksksss512.png,with_mask,19,46,40,69,21,23,280,400,0,0
maksssksksss512.png,with_mask,82,40,99,61,17,21,280,400,0,0
maksssksksss512.png,with_mask,98,26,132,64,34,38,280,400,0,0
maksssksksss512.png,with_mask,172,41,198,70,26,29,280,400,0,0
maksssksksss512.png,with_mask,261,56,280,74,19,18,280,400,0,0
maksssksksss512.png,with_mask,285,47,316,81,31,34,280,400,0,0
maksssksksss512.png,with_mask,384,38,400,64,16,26,280,400,0,0
maksssksksss513.png,with_mask,75,45,106,83,31,38,400,267,0,0
maksssksksss513.png,with_mask,112,39,140,68,28,29,400,267,0,0
maksssksksss513.png,with_mask,184,49,213,80,29,31,400,267,0,0
maksssksksss514.png,with_mask,28,78,43,99,15,21,267,400,0,0
maksssksksss514.png,with_mask,160,66,176,83,16,17,267,400,0,0
maksssksksss514.png,with_mask,174,33,186,52,12,19,267,400,0,0
maksssksksss514.png,with_mask,202,40,216,59,14,19,267,400,0,0
maksssksksss514.png,without_mask,237,41,248,58,11,17,267,400,0,0
maksssksksss514.png,mask_weared_incorrect,249,44,266,66,17,22,267,400,0,0
maksssksksss514.png,with_mask,298,38,311,54,13,16,267,400,0,0
maksssksksss514.png,with_mask,333,51,346,70,13,19,267,400,0,0
maksssksksss514.png,with_mask,375,47,386,63,11,16,267,400,0,0
maksssksksss514.png,mask_weared_incorrect,386,44,400,64,14,20,267,400,0,0
maksssksksss515.png,with_mask,57,198,164,330,107,132,400,301,0,0
maksssksksss516.png,with_mask,89,81,111,111,22,30,225,400,0,0
maksssksksss516.png,with_mask,128,62,158,92,30,30,225,400,0,0
maksssksksss516.png,with_mask,158,58,178,82,20,24,225,400,0,0
maksssksksss516.png,with_mask,192,50,221,83,29,33,225,400,0,0
maksssksksss516.png,with_mask,254,78,284,108,30,30,225,400,0,0
maksssksksss516.png,with_mask,327,61,346,81,19,20,225,400,0,0
maksssksksss516.png,with_mask,35,64,51,80,16,16,225,400,0,0
maksssksksss517.png,with_mask,62,135,92,158,30,23,267,400,0,0
maksssksksss517.png,with_mask,236,97,257,123,21,26,267,400,0,0
maksssksksss517.png,with_mask,339,89,352,102,13,13,267,400,0,0
maksssksksss517.png,with_mask,187,79,201,100,14,21,267,400,0,0
maksssksksss518.png,with_mask,104,149,116,162,12,13,225,400,0,0
maksssksksss518.png,with_mask,130,196,143,209,13,13,225,400,0,0
maksssksksss518.png,with_mask,152,152,164,164,12,12,225,400,0,0
maksssksksss518.png,with_mask,167,177,178,191,11,14,225,400,0,0
maksssksksss518.png,with_mask,154,174,166,188,12,14,225,400,0,0
maksssksksss518.png,with_mask,192,142,203,155,11,13,225,400,0,0
maksssksksss518.png,with_mask,247,192,260,205,13,13,225,400,0,0
maksssksksss518.png,with_mask,264,212,278,225,14,13,225,400,0,0
maksssksksss518.png,with_mask,287,133,299,145,12,12,225,400,0,0
maksssksksss519.png,with_mask,133,82,157,109,24,27,267,400,0,0
maksssksksss519.png,with_mask,217,76,243,103,26,27,267,400,0,0
maksssksksss519.png,with_mask,322,62,341,83,19,21,267,400,0,0
maksssksksss52.png,without_mask,37,166,84,214,47,48,225,400,0,0
maksssksksss52.png,without_mask,6,117,47,149,41,32,225,400,0,0
maksssksksss52.png,with_mask,2,77,35,99,33,22,225,400,0,0
maksssksksss52.png,with_mask,39,65,75,103,36,38,225,400,0,0
maksssksksss52.png,with_mask,76,69,92,88,16,19,225,400,0,0
maksssksksss52.png,without_mask,92,74,129,113,37,39,225,400,0,0
maksssksksss52.png,with_mask,116,132,161,175,45,43,225,400,0,0
maksssksksss52.png,with_mask,161,130,195,163,34,33,225,400,0,0
maksssksksss52.png,with_mask,209,119,262,170,53,51,225,400,0,0
maksssksksss52.png,with_mask,191,84,208,117,17,33,225,400,0,0
maksssksksss52.png,without_mask,131,67,157,97,26,30,225,400,0,0
maksssksksss52.png,mask_weared_incorrect,168,57,196,85,28,28,225,400,0,0
maksssksksss52.png,without_mask,221,51,246,77,25,26,225,400,0,0
maksssksksss52.png,without_mask,74,31,96,53,22,22,225,400,0,0
maksssksksss52.png,with_mask,63,37,77,56,14,19,225,400,0,0
maksssksksss52.png,with_mask,41,23,58,40,17,17,225,400,0,0
maksssksksss52.png,with_mask,1,34,24,61,23,27,225,400,0,0
maksssksksss52.png,mask_weared_incorrect,23,37,37,54,14,17,225,400,0,0
maksssksksss52.png,with_mask,73,5,84,16,11,11,225,400,0,0
maksssksksss52.png,with_mask,97,34,115,53,18,19,225,400,0,0
maksssksksss52.png,with_mask,157,61,173,84,16,23,225,400,0,0
maksssksksss52.png,with_mask,145,42,160,56,15,14,225,400,0,0
maksssksksss52.png,with_mask,127,31,142,44,15,13,225,400,0,0
maksssksksss52.png,with_mask,143,29,160,42,17,13,225,400,0,0
maksssksksss52.png,with_mask,159,21,171,32,12,11,225,400,0,0
maksssksksss52.png,without_mask,185,20,200,37,15,17,225,400,0,0
maksssksksss52.png,with_mask,197,37,214,58,17,21,225,400,0,0
maksssksksss52.png,with_mask,194,54,211,73,17,19,225,400,0,0
maksssksksss52.png,with_mask,250,4,261,16,11,12,225,400,0,0
maksssksksss52.png,mask_weared_incorrect,254,30,272,47,18,17,225,400,0,0
maksssksksss52.png,with_mask,260,74,285,97,25,23,225,400,0,0
maksssksksss52.png,with_mask,270,33,281,49,11,16,225,400,0,0
maksssksksss52.png,with_mask,268,110,279,127,11,17,225,400,0,0
maksssksksss52.png,with_mask,284,111,316,150,32,39,225,400,0,0
maksssksksss52.png,with_mask,303,147,352,203,49,56,225,400,0,0
maksssksksss52.png,with_mask,328,51,352,77,24,26,225,400,0,0
maksssksksss52.png,with_mask,352,48,366,71,14,23,225,400,0,0
maksssksksss52.png,with_mask,286,73,307,90,21,17,225,400,0,0
maksssksksss52.png,with_mask,310,39,329,58,19,19,225,400,0,0
maksssksksss52.png,with_mask,304,16,322,36,18,20,225,400,0,0
maksssksksss52.png,mask_weared_incorrect,326,11,338,30,12,19,225,400,0,0
maksssksksss520.png,with_mask,42,173,154,304,112,131,400,301,0,0
maksssksksss521.png,without_mask,178,35,265,133,87,98,225,400,0,0
maksssksksss522.png,without_mask,1,174,17,211,16,37,400,267,0,0
maksssksksss522.png,without_mask,112,134,150,182,38,48,400,267,0,0
maksssksksss522.png,without_mask,124,193,148,218,24,25,400,267,0,0
maksssksksss523.png,without_mask,81,92,167,190,86,98,267,400,0,0
maksssksksss523.png,with_mask,192,96,268,171,76,75,267,400,0,0
maksssksksss524.png,with_mask,244,165,292,220,48,55,292,400,0,0
maksssksksss524.png,with_mask,295,135,348,192,53,57,292,400,0,0
maksssksksss524.png,with_mask,365,118,389,148,24,30,292,400,0,0
maksssksksss524.png,with_mask,318,63,345,88,27,25,292,400,0,0
maksssksksss524.png,with_mask,366,55,379,75,13,20,292,400,0,0
maksssksksss524.png,with_mask,259,90,291,123,32,33,292,400,0,0
maksssksksss524.png,with_mask,244,47,262,69,18,22,292,400,0,0
maksssksksss524.png,with_mask,211,116,240,148,29,32,292,400,0,0
maksssksksss524.png,with_mask,133,116,162,151,29,35,292,400,0,0
maksssksksss524.png,with_mask,192,95,216,118,24,23,292,400,0,0
maksssksksss524.png,with_mask,89,112,113,134,24,22,292,400,0,0
maksssksksss524.png,with_mask,33,137,62,171,29,34,292,400,0,0
maksssksksss524.png,with_mask,10,100,32,123,22,23,292,400,0,0
maksssksksss524.png,with_mask,85,55,108,76,23,21,292,400,0,0
maksssksksss524.png,with_mask,133,39,154,61,21,22,292,400,0,0
maksssksksss524.png,with_mask,186,56,198,72,12,16,292,400,0,0
maksssksksss524.png,with_mask,207,66,220,84,13,18,292,400,0,0
maksssksksss524.png,with_mask,46,40,69,62,23,22,292,400,0,0
maksssksksss525.png,mask_weared_incorrect,319,128,486,307,167,179,399,600,0,0
maksssksksss526.png,without_mask,66,30,100,66,34,36,263,400,0,0
maksssksksss526.png,with_mask,165,85,200,120,35,35,263,400,0,0
maksssksksss526.png,with_mask,251,88,285,123,34,35,263,400,0,0
maksssksksss526.png,without_mask,309,107,350,146,41,39,263,400,0,0
maksssksksss527.png,without_mask,97,21,113,40,16,19,225,400,0,0
maksssksksss527.png,without_mask,26,57,46,81,20,24,225,400,0,0
maksssksksss527.png,without_mask,141,111,165,137,24,26,225,400,0,0
maksssksksss527.png,with_mask,190,76,219,106,29,30,225,400,0,0
maksssksksss527.png,without_mask,248,54,269,72,21,18,225,400,0,0
maksssksksss527.png,without_mask,244,82,270,108,26,26,225,400,0,0
maksssksksss528.png,without_mask,43,169,149,308,106,139,400,301,0,0
maksssksksss529.png,with_mask,12,58,45,86,33,28,226,400,0,0
maksssksksss529.png,with_mask,135,53,164,83,29,30,226,400,0,0
maksssksksss529.png,without_mask,170,89,182,103,12,14,226,400,0,0
maksssksksss529.png,with_mask,239,53,278,91,39,38,226,400,0,0
maksssksksss529.png,with_mask,336,32,386,78,50,46,226,400,0,0
maksssksksss53.png,with_mask,82,63,103,87,21,24,226,400,0,0
maksssksksss53.png,with_mask,194,30,216,56,22,26,226,400,0,0
maksssksksss53.png,with_mask,200,91,234,128,34,37,226,400,0,0
maksssksksss530.png,without_mask,76,236,149,349,73,113,400,301,0,0
maksssksksss531.png,with_mask,92,201,172,322,80,121,400,301,0,0
maksssksksss532.png,with_mask,71,197,169,322,98,125,400,301,0,0
maksssksksss533.png,with_mask,101,203,205,347,104,144,400,301,0,0
maksssksksss534.png,with_mask,21,152,34,168,13,16,267,400,0,0
maksssksksss534.png,with_mask,71,161,85,174,14,13,267,400,0,0
maksssksksss534.png,with_mask,112,124,132,148,20,24,267,400,0,0
maksssksksss534.png,with_mask,165,149,180,171,15,22,267,400,0,0
maksssksksss534.png,with_mask,228,142,241,157,13,15,267,400,0,0
maksssksksss534.png,with_mask,289,153,303,166,14,13,267,400,0,0
maksssksksss534.png,mask_weared_incorrect,346,132,364,153,18,21,267,400,0,0
maksssksksss535.png,with_mask,43,38,59,55,16,17,261,400,0,0
maksssksksss535.png,with_mask,93,32,118,63,25,31,261,400,0,0
maksssksksss535.png,with_mask,318,35,330,51,12,16,261,400,0,0
maksssksksss535.png,with_mask,353,40,368,58,15,18,261,400,0,0
maksssksksss536.png,with_mask,107,158,197,287,90,129,400,301,0,0
maksssksksss537.png,without_mask,95,177,195,295,100,118,400,301,0,0
maksssksksss538.png,with_mask,122,80,142,104,20,24,225,400,0,0
maksssksksss538.png,with_mask,249,57,275,86,26,29,225,400,0,0
maksssksksss539.png,with_mask,167,3,178,15,11,12,267,400,0,0
maksssksksss539.png,with_mask,21,48,34,62,13,14,267,400,0,0
maksssksksss539.png,with_mask,53,40,66,52,13,12,267,400,0,0
maksssksksss539.png,with_mask,107,37,119,51,12,14,267,400,0,0
maksssksksss539.png,with_mask,116,56,128,68,12,12,267,400,0,0
maksssksksss539.png,with_mask,91,77,104,89,13,12,267,400,0,0
maksssksksss539.png,with_mask,25,72,40,86,15,14,267,400,0,0
maksssksksss539.png,with_mask,8,90,22,105,14,15,267,400,0,0
maksssksksss539.png,with_mask,36,105,50,117,14,12,267,400,0,0
maksssksksss539.png,with_mask,36,122,48,138,12,16,267,400,0,0
maksssksksss539.png,with_mask,60,131,73,146,13,15,267,400,0,0
maksssksksss539.png,with_mask,61,152,79,169,18,17,267,400,0,0
maksssksksss539.png,with_mask,42,206,60,222,18,16,267,400,0,0
maksssksksss539.png,with_mask,52,238,70,257,18,19,267,400,0,0
maksssksksss539.png,with_mask,93,226,111,241,18,15,267,400,0,0
maksssksksss539.png,with_mask,124,128,140,142,16,14,267,400,0,0
maksssksksss539.png,with_mask,134,90,146,103,12,13,267,400,0,0
maksssksksss539.png,with_mask,143,210,161,229,18,19,267,400,0,0
maksssksksss539.png,with_mask,170,142,185,160,15,18,267,400,0,0
maksssksksss539.png,with_mask,205,37,217,49,12,12,267,400,0,0
maksssksksss539.png,with_mask,231,25,242,37,11,12,267,400,0,0
maksssksksss539.png,with_mask,220,49,232,61,12,12,267,400,0,0
maksssksksss539.png,with_mask,258,46,271,58,13,12,267,400,0,0
maksssksksss539.png,with_mask,247,60,261,76,14,16,267,400,0,0
maksssksksss539.png,with_mask,233,101,247,116,14,15,267,400,0,0
maksssksksss539.png,with_mask,214,124,228,141,14,17,267,400,0,0
maksssksksss539.png,with_mask,279,203,296,222,17,19,267,400,0,0
maksssksksss539.png,with_mask,302,93,316,110,14,17,267,400,0,0
maksssksksss539.png,with_mask,313,139,328,155,15,16,267,400,0,0
maksssksksss539.png,with_mask,376,89,391,100,15,11,267,400,0,0
maksssksksss539.png,with_mask,353,125,367,140,14,15,267,400,0,0
maksssksksss539.png,with_mask,363,176,376,192,13,16,267,400,0,0
maksssksksss539.png,with_mask,372,191,392,205,20,14,267,400,0,0
maksssksksss54.png,with_mask,119,40,157,80,38,40,267,400,0,0
maksssksksss54.png,with_mask,197,68,227,110,30,42,267,400,0,0
maksssksksss54.png,with_mask,316,81,338,113,22,32,267,400,0,0
maksssksksss54.png,without_mask,161,78,178,98,17,20,267,400,0,0
maksssksksss540.png,without_mask,107,129,202,245,95,116,400,301,0,0
maksssksksss541.png,with_mask,104,144,213,285,109,141,400,301,0,0
maksssksksss542.png,with_mask,163,47,239,137,76,90,210,400,0,0
maksssksksss543.png,without_mask,101,50,112,63,11,13,210,400,0,0
maksssksksss543.png,without_mask,194,34,205,51,11,17,210,400,0,0
maksssksksss543.png,without_mask,230,24,243,41,13,17,210,400,0,0
maksssksksss543.png,without_mask,252,51,270,69,18,18,210,400,0,0
maksssksksss543.png,without_mask,267,42,278,55,11,13,210,400,0,0
maksssksksss543.png,without_mask,337,31,350,46,13,15,210,400,0,0
maksssksksss544.png,without_mask,145,200,240,324,95,124,400,301,0,0
maksssksksss545.png,with_mask,328,33,350,57,22,24,267,400,0,0
maksssksksss545.png,mask_weared_incorrect,366,70,384,92,18,22,267,400,0,0
maksssksksss545.png,with_mask,249,44,268,63,19,19,267,400,0,0
maksssksksss545.png,with_mask,278,71,292,87,14,16,267,400,0,0
maksssksksss545.png,with_mask,29,47,46,67,17,20,267,400,0,0
maksssksksss545.png,mask_weared_incorrect,37,63,59,88,22,25,267,400,0,0
maksssksksss545.png,mask_weared_incorrect,179,40,205,67,26,27,267,400,0,0
maksssksksss545.png,without_mask,68,67,90,91,22,24,267,400,0,0
maksssksksss545.png,without_mask,1,46,18,63,17,17,267,400,0,0
maksssksksss545.png,without_mask,137,57,155,76,18,19,267,400,0,0
maksssksksss545.png,without_mask,235,51,249,67,14,16,267,400,0,0
maksssksksss545.png,without_mask,282,33,301,51,19,18,267,400,0,0
maksssksksss545.png,without_mask,89,54,103,71,14,17,267,400,0,0
maksssksksss546.png,with_mask,27,177,140,311,113,134,400,301,0,0
maksssksksss547.png,with_mask,84,39,100,56,16,17,267,400,0,0
maksssksksss547.png,with_mask,192,31,212,51,20,20,267,400,0,0
maksssksksss547.png,with_mask,315,48,332,68,17,20,267,400,0,0
maksssksksss548.png,with_mask,185,79,215,110,30,31,300,400,0,0
maksssksksss548.png,without_mask,256,66,273,85,17,19,300,400,0,0
maksssksksss549.png,with_mask,145,98,181,132,36,34,283,400,0,0
maksssksksss55.png,with_mask,116,141,234,291,118,150,400,301,0,0
maksssksksss550.png,with_mask,118,78,239,204,121,126,350,350,0,0
maksssksksss551.png,with_mask,41,56,82,99,41,43,267,400,0,0
maksssksksss551.png,with_mask,149,108,186,146,37,38,267,400,0,0
maksssksksss551.png,with_mask,255,146,290,184,35,38,267,400,0,0
maksssksksss551.png,with_mask,342,143,378,178,36,35,267,400,0,0
maksssksksss551.png,with_mask,203,114,241,149,38,35,267,400,0,0
maksssksksss552.png,with_mask,155,37,228,111,73,74,267,400,0,0
maksssksksss553.png,with_mask,143,190,207,293,64,103,400,301,0,0
maksssksksss554.png,with_mask,96,44,117,73,21,29,281,400,0,0
maksssksksss554.png,with_mask,84,162,106,182,22,20,281,400,0,0
maksssksksss554.png,with_mask,167,50,193,83,26,33,281,400,0,0
maksssksksss554.png,with_mask,229,24,265,71,36,47,281,400,0,0
maksssksksss554.png,with_mask,265,57,289,89,24,32,281,400,0,0
maksssksksss555.png,with_mask,95,111,111,128,16,17,225,400,0,0
maksssksksss555.png,with_mask,162,95,179,115,17,20,225,400,0,0
maksssksksss555.png,with_mask,256,98,270,114,14,16,225,400,0,0
maksssksksss555.png,with_mask,310,108,327,130,17,22,225,400,0,0
maksssksksss556.png,with_mask,81,57,104,78,23,21,198,400,0,0
maksssksksss556.png,with_mask,106,37,136,66,30,29,198,400,0,0
maksssksksss556.png,with_mask,150,58,177,87,27,29,198,400,0,0
maksssksksss556.png,with_mask,130,118,155,146,25,28,198,400,0,0
maksssksksss556.png,with_mask,178,34,197,59,19,25,198,400,0,0
maksssksksss556.png,with_mask,204,28,223,51,19,23,198,400,0,0
maksssksksss556.png,with_mask,180,160,205,186,25,26,198,400,0,0
maksssksksss556.png,with_mask,279,34,309,66,30,32,198,400,0,0
maksssksksss556.png,with_mask,347,1,377,29,30,28,198,400,0,0
maksssksksss556.png,with_mask,376,7,400,40,24,33,198,400,0,0
maksssksksss557.png,with_mask,58,167,173,317,115,150,400,301,0,0
maksssksksss558.png,with_mask,5,134,73,206,68,72,226,400,0,0
maksssksksss558.png,with_mask,85,118,126,161,41,43,226,400,0,0
maksssksksss558.png,without_mask,108,74,134,98,26,24,226,400,0,0
maksssksksss558.png,with_mask,148,100,182,133,34,33,226,400,0,0
maksssksksss558.png,without_mask,184,67,198,94,14,27,226,400,0,0
maksssksksss558.png,with_mask,198,72,241,120,43,48,226,400,0,0
maksssksksss558.png,with_mask,241,75,275,116,34,41,226,400,0,0
maksssksksss558.png,without_mask,261,22,279,41,18,19,226,400,0,0
maksssksksss558.png,with_mask,337,40,356,57,19,17,226,400,0,0
maksssksksss558.png,with_mask,357,30,379,53,22,23,226,400,0,0
maksssksksss558.png,with_mask,287,62,306,81,19,19,226,400,0,0
maksssksksss558.png,with_mask,299,79,328,111,29,32,226,400,0,0
maksssksksss558.png,with_mask,371,84,398,115,27,31,226,400,0,0
maksssksksss558.png,with_mask,275,187,329,225,54,38,226,400,0,0
maksssksksss558.png,with_mask,171,17,184,30,13,13,226,400,0,0
maksssksksss558.png,without_mask,233,23,245,39,12,16,226,400,0,0
maksssksksss558.png,without_mask,305,6,318,17,13,11,226,400,0,0
maksssksksss559.png,with_mask,7,215,50,256,43,41,256,400,0,0
maksssksksss559.png,with_mask,64,190,92,219,28,29,256,400,0,0
maksssksksss559.png,with_mask,96,161,148,220,52,59,256,400,0,0
maksssksksss559.png,with_mask,183,137,214,179,31,42,256,400,0,0
maksssksksss559.png,with_mask,120,53,138,72,18,19,256,400,0,0
maksssksksss559.png,with_mask,153,22,168,37,15,15,256,400,0,0
maksssksksss559.png,with_mask,163,55,177,73,14,18,256,400,0,0
maksssksksss559.png,with_mask,194,31,206,42,12,11,256,400,0,0
maksssksksss559.png,with_mask,230,32,245,48,15,16,256,400,0,0
maksssksksss559.png,with_mask,219,88,234,105,15,17,256,400,0,0
maksssksksss559.png,with_mask,257,124,298,165,41,41,256,400,0,0
maksssksksss559.png,with_mask,296,43,310,57,14,14,256,400,0,0
maksssksksss559.png,without_mask,332,81,347,96,15,15,256,400,0,0
maksssksksss559.png,without_mask,259,44,274,60,15,16,256,400,0,0
maksssksksss559.png,without_mask,170,108,189,127,19,19,256,400,0,0
maksssksksss56.png,with_mask,191,105,258,183,67,78,267,400,0,0
maksssksksss560.png,with_mask,179,126,219,165,40,39,267,400,0,0
maksssksksss561.png,without_mask,81,163,184,279,103,116,400,301,0,0
maksssksksss562.png,mask_weared_incorrect,163,81,241,173,78,92,210,400,0,0
maksssksksss563.png,with_mask,70,53,204,205,134,152,225,400,0,0
maksssksksss564.png,with_mask,63,85,94,118,31,33,226,400,0,0
maksssksksss564.png,without_mask,129,106,185,172,56,66,226,400,0,0
maksssksksss564.png,with_mask,25,64,49,91,24,27,226,400,0,0
maksssksksss564.png,mask_weared_incorrect,58,29,76,52,18,23,226,400,0,0
maksssksksss564.png,without_mask,78,65,100,85,22,20,226,400,0,0
maksssksksss564.png,with_mask,103,50,124,68,21,18,226,400,0,0
maksssksksss564.png,with_mask,128,45,152,64,24,19,226,400,0,0
maksssksksss564.png,with_mask,161,56,181,74,20,18,226,400,0,0
maksssksksss564.png,with_mask,178,69,201,93,23,24,226,400,0,0
maksssksksss564.png,with_mask,206,74,233,93,27,19,226,400,0,0
maksssksksss564.png,without_mask,179,31,193,47,14,16,226,400,0,0
maksssksksss564.png,with_mask,252,86,289,121,37,35,226,400,0,0
maksssksksss564.png,with_mask,45,37,60,56,15,19,226,400,0,0
maksssksksss564.png,with_mask,98,34,116,49,18,15,226,400,0,0
maksssksksss564.png,with_mask,306,183,333,225,27,42,226,400,0,0
maksssksksss564.png,with_mask,319,103,354,142,35,39,226,400,0,0
maksssksksss564.png,with_mask,317,54,344,77,27,23,226,400,0,0
maksssksksss564.png,with_mask,320,86,335,107,15,21,226,400,0,0
maksssksksss564.png,with_mask,303,36,320,59,17,23,226,400,0,0
maksssksksss564.png,with_mask,342,32,355,47,13,15,226,400,0,0
maksssksksss565.png,without_mask,134,191,229,316,95,125,400,301,0,0
maksssksksss566.png,with_mask,101,76,128,101,27,25,300,400,0,0
maksssksksss566.png,mask_weared_incorrect,237,73,255,89,18,16,300,400,0,0
maksssksksss566.png,with_mask,195,70,210,103,15,33,300,400,0,0
maksssksksss566.png,with_mask,267,74,290,99,23,25,300,400,0,0
maksssksksss566.png,with_mask,37,87,48,100,11,13,300,400,0,0
maksssksksss566.png,with_mask,1,87,14,99,13,12,300,400,0,0
maksssksksss567.png,with_mask,80,61,116,100,36,39,267,400,0,0
maksssksksss567.png,with_mask,228,42,260,80,32,38,267,400,0,0
maksssksksss567.png,with_mask,304,47,339,84,35,37,267,400,0,0
maksssksksss567.png,without_mask,135,69,156,90,21,21,267,400,0,0
maksssksksss567.png,without_mask,35,69,55,91,20,22,267,400,0,0
maksssksksss568.png,with_mask,101,195,194,308,93,113,400,301,0,0
maksssksksss569.png,with_mask,161,97,197,149,36,52,226,400,0,0
maksssksksss57.png,with_mask,101,251,162,355,61,104,400,301,0,0
maksssksksss570.png,with_mask,148,130,176,161,28,31,266,400,0,0
maksssksksss570.png,with_mask,233,126,261,155,28,29,266,400,0,0
maksssksksss570.png,without_mask,43,138,62,160,19,22,266,400,0,0
maksssksksss570.png,without_mask,108,115,131,137,23,22,266,400,0,0
maksssksksss570.png,without_mask,288,116,303,138,15,22,266,400,0,0
maksssksksss570.png,without_mask,318,133,336,151,18,18,266,400,0,0
maksssksksss570.png,without_mask,365,129,382,148,17,19,266,400,0,0
maksssksksss570.png,without_mask,188,132,199,147,11,15,266,400,0,0
maksssksksss571.png,without_mask,122,196,210,319,88,123,400,301,0,0
maksssksksss572.png,with_mask,109,115,142,150,33,35,225,400,0,0
maksssksksss572.png,with_mask,168,9,199,42,31,33,225,400,0,0
maksssksksss572.png,with_mask,194,48,231,86,37,38,225,400,0,0
maksssksksss572.png,with_mask,216,21,246,54,30,33,225,400,0,0
maksssksksss572.png,with_mask,279,69,300,91,21,22,225,400,0,0
maksssksksss572.png,with_mask,337,73,357,95,20,22,225,400,0,0
maksssksksss573.png,with_mask,442,45,494,100,52,55,287,510,0,0
maksssksksss573.png,with_mask,408,77,449,133,41,56,287,510,0,0
maksssksksss573.png,with_mask,188,60,267,139,79,79,287,510,0,0
maksssksksss573.png,with_mask,270,53,308,125,38,72,287,510,0,0
maksssksksss573.png,with_mask,85,117,158,189,73,72,287,510,0,0
maksssksksss573.png,with_mask,16,140,81,183,65,43,287,510,0,0
maksssksksss574.png,with_mask,92,17,140,74,48,57,225,400,0,0
maksssksksss574.png,with_mask,192,61,230,102,38,41,225,400,0,0
maksssksksss574.png,with_mask,250,107,273,132,23,25,225,400,0,0
maksssksksss574.png,with_mask,281,127,302,145,21,18,225,400,0,0
maksssksksss574.png,with_mask,313,107,333,129,20,22,225,400,0,0
maksssksksss574.png,with_mask,341,139,355,158,14,19,225,400,0,0
maksssksksss575.png,with_mask,170,43,195,69,25,26,225,400,0,0
maksssksksss575.png,without_mask,36,99,54,114,18,15,225,400,0,0
maksssksksss575.png,without_mask,234,153,258,186,24,33,225,400,0,0
maksssksksss575.png,without_mask,383,127,400,150,17,23,225,400,0,0
maksssksksss576.png,with_mask,105,70,180,155,75,85,295,400,0,0
maksssksksss576.png,with_mask,176,79,259,175,83,96,295,400,0,0
maksssksksss577.png,with_mask,106,61,117,72,11,11,267,400,0,0
maksssksksss577.png,without_mask,137,67,152,80,15,13,267,400,0,0
maksssksksss577.png,with_mask,188,55,203,72,15,17,267,400,0,0
maksssksksss577.png,with_mask,237,70,256,88,19,18,267,400,0,0
maksssksksss577.png,with_mask,279,79,297,97,18,18,267,400,0,0
maksssksksss577.png,with_mask,323,69,348,92,25,23,267,400,0,0
maksssksksss577.png,with_mask,384,62,400,92,16,30,267,400,0,0
maksssksksss578.png,without_mask,139,213,153,231,14,18,282,400,0,0
maksssksksss578.png,with_mask,191,117,222,154,31,37,282,400,0,0
maksssksksss578.png,with_mask,307,123,340,161,33,38,282,400,0,0
maksssksksss579.png,with_mask,150,26,193,86,43,60,226,400,0,0
maksssksksss579.png,with_mask,204,127,245,175,41,48,226,400,0,0
maksssksksss579.png,without_mask,274,51,286,72,12,21,226,400,0,0
maksssksksss58.png,with_mask,25,75,43,95,18,20,267,400,0,0
maksssksksss58.png,with_mask,52,68,67,84,15,16,267,400,0,0
maksssksksss58.png,with_mask,74,61,86,74,12,13,267,400,0,0
maksssksksss58.png,with_mask,98,78,117,97,19,19,267,400,0,0
maksssksksss58.png,with_mask,159,75,178,94,19,19,267,400,0,0
maksssksksss58.png,with_mask,187,49,220,84,33,35,267,400,0,0
maksssksksss58.png,with_mask,234,53,251,76,17,23,267,400,0,0
maksssksksss58.png,with_mask,273,81,285,93,12,12,267,400,0,0
maksssksksss58.png,with_mask,297,65,314,85,17,20,267,400,0,0
maksssksksss58.png,with_mask,335,81,349,97,14,16,267,400,0,0
maksssksksss58.png,with_mask,369,73,383,90,14,17,267,400,0,0
maksssksksss580.png,with_mask,100,57,148,100,48,43,400,267,0,0
maksssksksss581.png,with_mask,86,194,195,340,109,146,400,301,0,0
maksssksksss582.png,with_mask,160,127,321,309,161,182,400,400,0,0
maksssksksss583.png,with_mask,274,54,345,133,71,79,225,400,0,0
maksssksksss583.png,with_mask,157,67,237,164,80,97,225,400,0,0
maksssksksss583.png,with_mask,34,57,106,132,72,75,225,400,0,0
maksssksksss584.png,with_mask,2,44,33,81,31,37,267,400,0,0
maksssksksss584.png,with_mask,83,84,112,118,29,34,267,400,0,0
maksssksksss584.png,with_mask,152,104,181,136,29,32,267,400,0,0
maksssksksss584.png,with_mask,218,92,243,127,25,35,267,400,0,0
maksssksksss584.png,with_mask,268,94,297,121,29,27,267,400,0,0
maksssksksss584.png,with_mask,316,96,342,122,26,26,267,400,0,0
maksssksksss584.png,with_mask,344,92,357,112,13,20,267,400,0,0
maksssksksss584.png,without_mask,359,92,381,116,22,24,267,400,0,0
maksssksksss584.png,without_mask,189,74,216,98,27,24,267,400,0,0
maksssksksss584.png,without_mask,250,82,266,110,16,28,267,400,0,0
maksssksksss585.png,without_mask,7,116,55,163,48,47,399,400,0,0
maksssksksss585.png,with_mask,110,112,161,161,51,49,399,400,0,0
maksssksksss585.png,with_mask,162,134,227,210,65,76,399,400,0,0
maksssksksss585.png,without_mask,229,120,255,160,26,40,399,400,0,0
maksssksksss585.png,with_mask,267,143,326,200,59,57,399,400,0,0
maksssksksss585.png,without_mask,343,129,400,183,57,54,399,400,0,0
maksssksksss586.png,with_mask,111,106,146,164,35,58,267,400,0,0
maksssksksss586.png,with_mask,194,115,224,164,30,49,267,400,0,0
maksssksksss586.png,with_mask,22,120,50,161,28,41,267,400,0,0
maksssksksss587.png,with_mask,69,152,99,181,30,29,312,400,0,0
maksssksksss587.png,with_mask,208,24,247,58,39,34,312,400,0,0
maksssksksss588.png,with_mask,81,109,104,138,23,29,267,400,0,0
maksssksksss588.png,with_mask,182,69,199,101,17,32,267,400,0,0
maksssksksss588.png,with_mask,326,122,354,152,28,30,267,400,0,0
maksssksksss589.png,with_mask,88,95,178,185,90,90,400,267,0,0
maksssksksss59.png,with_mask,94,133,109,148,15,15,267,400,0,0
maksssksksss59.png,with_mask,140,105,158,120,18,15,267,400,0,0
maksssksksss59.png,with_mask,174,98,190,114,16,16,267,400,0,0
maksssksksss59.png,with_mask,230,99,244,115,14,16,267,400,0,0
maksssksksss59.png,with_mask,294,108,307,123,13,15,267,400,0,0
maksssksksss590.png,with_mask,66,189,172,316,106,127,400,301,0,0
maksssksksss591.png,with_mask,137,101,195,172,58,71,267,400,0,0
maksssksksss592.png,with_mask,121,227,384,495,263,268,600,600,0,0
maksssksksss593.png,with_mask,75,107,126,185,51,78,226,400,0,0
maksssksksss593.png,with_mask,122,78,183,141,61,63,226,400,0,0
maksssksksss593.png,with_mask,196,98,235,148,39,50,226,400,0,0
maksssksksss594.png,with_mask,11,64,40,94,29,30,267,400,0,0
maksssksksss594.png,with_mask,88,61,119,95,31,34,267,400,0,0
maksssksksss594.png,with_mask,184,49,210,83,26,34,267,400,0,0
maksssksksss594.png,with_mask,217,64,246,97,29,33,267,400,0,0
maksssksksss594.png,with_mask,243,52,271,78,28,26,267,400,0,0
maksssksksss594.png,with_mask,276,42,311,70,35,28,267,400,0,0
maksssksksss594.png,with_mask,322,35,346,66,24,31,267,400,0,0
maksssksksss594.png,with_mask,353,26,384,61,31,35,267,400,0,0
maksssksksss595.png,with_mask,46,78,65,96,19,18,267,400,0,0
maksssksksss595.png,with_mask,118,75,134,93,16,18,267,400,0,0
maksssksksss595.png,with_mask,157,76,173,96,16,20,267,400,0,0
maksssksksss595.png,with_mask,175,68,191,87,16,19,267,400,0,0
maksssksksss595.png,with_mask,243,77,260,96,17,19,267,400,0,0
maksssksksss595.png,with_mask,294,78,311,98,17,20,267,400,0,0
maksssksksss596.png,with_mask,101,151,228,327,127,176,400,301,0,0
maksssksksss597.png,with_mask,295,125,317,149,22,24,267,400,0,0
maksssksksss597.png,with_mask,344,115,366,142,22,27,267,400,0,0
maksssksksss598.png,with_mask,111,203,221,355,110,152,400,301,0,0
maksssksksss599.png,with_mask,86,144,198,281,112,137,400,301,0,0
maksssksksss6.png,with_mask,254,100,387,260,133,160,405,600,0,0
maksssksksss60.png,with_mask,78,176,178,304,100,128,400,301,0,0
maksssksksss600.png,with_mask,143,77,252,184,109,107,250,400,0,0
maksssksksss601.png,with_mask,84,163,184,300,100,137,400,301,0,0
maksssksksss602.png,with_mask,251,22,270,44,19,22,226,400,0,0
maksssksksss603.png,with_mask,47,98,58,109,11,11,278,400,0,0
maksssksksss603.png,with_mask,47,127,59,138,12,11,278,400,0,0
maksssksksss603.png,without_mask,40,154,51,165,11,11,278,400,0,0
maksssksksss603.png,mask_weared_incorrect,111,151,122,163,11,12,278,400,0,0
maksssksksss603.png,with_mask,99,165,111,177,12,12,278,400,0,0
maksssksksss603.png,with_mask,124,210,137,224,13,14,278,400,0,0
maksssksksss603.png,with_mask,91,257,106,272,15,15,278,400,0,0
maksssksksss603.png,with_mask,159,192,170,205,11,13,278,400,0,0
maksssksksss603.png,with_mask,158,254,173,269,15,15,278,400,0,0
maksssksksss603.png,with_mask,183,159,194,170,11,11,278,400,0,0
maksssksksss603.png,with_mask,236,206,249,219,13,13,278,400,0,0
maksssksksss603.png,with_mask,213,236,227,250,14,14,278,400,0,0
maksssksksss603.png,with_mask,253,225,266,238,13,13,278,400,0,0
maksssksksss603.png,with_mask,275,149,286,161,11,12,278,400,0,0
maksssksksss603.png,with_mask,297,248,311,263,14,15,278,400,0,0
maksssksksss603.png,with_mask,354,267,370,278,16,11,278,400,0,0
maksssksksss603.png,with_mask,358,219,371,231,13,12,278,400,0,0
maksssksksss603.png,with_mask,372,212,383,226,11,14,278,400,0,0
maksssksksss603.png,with_mask,373,163,384,175,11,12,278,400,0,0
maksssksksss603.png,with_mask,373,144,384,155,11,11,278,400,0,0
maksssksksss604.png,with_mask,73,58,121,109,48,51,226,400,0,0
maksssksksss604.png,with_mask,247,40,304,94,57,54,226,400,0,0
maksssksksss605.png,with_mask,132,47,159,81,27,34,400,267,0,0
maksssksksss606.png,with_mask,224,102,256,135,32,33,267,400,0,0
maksssksksss606.png,with_mask,133,126,158,149,25,23,267,400,0,0
maksssksksss607.png,with_mask,67,70,146,161,79,91,277,400,0,0
maksssksksss607.png,with_mask,239,81,357,175,118,94,277,400,0,0
maksssksksss608.png,with_mask,109,139,218,271,109,132,400,301,0,0
maksssksksss609.png,without_mask,91,103,239,265,148,162,400,301,0,0
maksssksksss61.png,with_mask,3,151,51,234,48,83,273,400,0,0
maksssksksss61.png,without_mask,162,9,178,27,16,18,273,400,0,0
maksssksksss61.png,with_mask,117,7,141,26,24,19,273,400,0,0
maksssksksss61.png,with_mask,11,1,33,12,22,11,273,400,0,0
maksssksksss61.png,with_mask,93,37,114,59,21,22,273,400,0,0
maksssksksss61.png,with_mask,125,37,153,65,28,28,273,400,0,0
maksssksksss61.png,without_mask,228,48,244,67,16,19,273,400,0,0
maksssksksss61.png,without_mask,209,61,233,84,24,23,273,400,0,0
maksssksksss61.png,with_mask,264,27,287,53,23,26,273,400,0,0
maksssksksss61.png,with_mask,322,43,340,65,18,22,273,400,0,0
maksssksksss61.png,with_mask,295,117,328,146,33,29,273,400,0,0
maksssksksss61.png,with_mask,361,86,386,109,25,23,273,400,0,0
maksssksksss61.png,with_mask,185,99,213,130,28,31,273,400,0,0
maksssksksss610.png,with_mask,117,66,141,93,24,27,210,400,0,0
maksssksksss610.png,with_mask,122,124,137,139,15,15,210,400,0,0
maksssksksss610.png,with_mask,192,22,227,63,35,41,210,400,0,0
maksssksksss611.png,with_mask,33,36,52,63,19,27,267,400,0,0
maksssksksss611.png,with_mask,96,63,114,83,18,20,267,400,0,0
maksssksksss611.png,with_mask,243,68,258,87,15,19,267,400,0,0
maksssksksss611.png,mask_weared_incorrect,292,76,305,94,13,18,267,400,0,0
maksssksksss612.png,with_mask,173,88,296,231,123,143,295,400,0,0
maksssksksss613.png,with_mask,36,104,49,127,13,23,267,400,0,0
maksssksksss613.png,without_mask,194,102,206,117,12,15,267,400,0,0
maksssksksss613.png,with_mask,176,141,197,166,21,25,267,400,0,0
maksssksksss613.png,with_mask,238,131,260,152,22,21,267,400,0,0
maksssksksss613.png,with_mask,305,120,319,132,14,12,267,400,0,0
maksssksksss613.png,mask_weared_incorrect,322,144,341,167,19,23,267,400,0,0
maksssksksss614.png,with_mask,103,197,207,332,104,135,400,301,0,0
maksssksksss615.png,without_mask,85,270,154,373,69,103,400,301,0,0
maksssksksss616.png,with_mask,1,121,18,142,17,21,267,400,0,0
maksssksksss616.png,with_mask,27,112,45,131,18,19,267,400,0,0
maksssksksss616.png,with_mask,68,112,87,131,19,19,267,400,0,0
maksssksksss616.png,with_mask,107,106,124,123,17,17,267,400,0,0
maksssksksss616.png,with_mask,131,109,149,131,18,22,267,400,0,0
maksssksksss616.png,with_mask,185,115,203,135,18,20,267,400,0,0
maksssksksss616.png,with_mask,197,103,208,126,11,23,267,400,0,0
maksssksksss616.png,with_mask,267,76,288,101,21,25,267,400,0,0
maksssksksss616.png,with_mask,337,83,361,107,24,24,267,400,0,0
maksssksksss616.png,with_mask,362,90,381,111,19,21,267,400,0,0
maksssksksss616.png,without_mask,249,110,263,129,14,19,267,400,0,0
maksssksksss616.png,without_mask,154,122,171,142,17,20,267,400,0,0
maksssksksss616.png,without_mask,95,115,114,137,19,22,267,400,0,0
maksssksksss617.png,with_mask,157,108,244,208,87,100,399,400,0,0
maksssksksss618.png,without_mask,118,171,212,297,94,126,400,301,0,0
maksssksksss619.png,with_mask,151,115,172,135,21,20,301,400,0,0
maksssksksss619.png,with_mask,241,126,262,146,21,20,301,400,0,0
maksssksksss619.png,without_mask,305,125,317,139,12,14,301,400,0,0
maksssksksss62.png,with_mask,80,180,212,356,132,176,400,301,0,0
maksssksksss620.png,with_mask,72,76,102,105,30,29,267,400,0,0
maksssksksss620.png,with_mask,140,68,167,95,27,27,267,400,0,0
maksssksksss620.png,with_mask,215,69,238,94,23,25,267,400,0,0
maksssksksss620.png,with_mask,304,144,315,156,11,12,267,400,0,0
maksssksksss620.png,without_mask,320,125,334,140,14,15,267,400,0,0
maksssksksss620.png,without_mask,363,126,385,147,22,21,267,400,0,0
maksssksksss621.png,without_mask,14,52,68,137,54,85,226,400,0,0
maksssksksss621.png,with_mask,191,35,208,54,17,19,226,400,0,0
maksssksksss621.png,with_mask,162,111,192,137,30,26,226,400,0,0
maksssksksss621.png,with_mask,299,46,386,141,87,95,226,400,0,0
maksssksksss621.png,with_mask,218,29,235,48,17,19,226,400,0,0
maksssksksss622.png,with_mask,138,66,171,99,33,33,300,400,0,0
maksssksksss622.png,with_mask,267,59,299,86,32,27,300,400,0,0
maksssksksss622.png,with_mask,322,76,342,100,20,24,300,400,0,0
maksssksksss622.png,with_mask,352,62,380,94,28,32,300,400,0,0
maksssksksss622.png,with_mask,377,83,394,102,17,19,300,400,0,0
maksssksksss623.png,with_mask,4,202,30,230,26,28,245,400,0,0
maksssksksss623.png,with_mask,38,179,64,206,26,27,245,400,0,0
maksssksksss623.png,mask_weared_incorrect,57,164,78,187,21,23,245,400,0,0
maksssksksss623.png,without_mask,30,109,47,126,17,17,245,400,0,0
maksssksksss623.png,with_mask,26,76,42,98,16,22,245,400,0,0
maksssksksss623.png,with_mask,4,70,18,88,14,18,245,400,0,0
maksssksksss623.png,without_mask,23,2,43,22,20,20,245,400,0,0
maksssksksss623.png,with_mask,109,9,130,29,21,20,245,400,0,0
maksssksksss623.png,with_mask,93,58,115,75,22,17,245,400,0,0
maksssksksss623.png,with_mask,97,111,115,133,18,22,245,400,0,0
maksssksksss623.png,with_mask,136,214,164,240,28,26,245,400,0,0
maksssksksss623.png,with_mask,195,173,220,193,25,20,245,400,0,0
maksssksksss623.png,with_mask,212,190,241,215,29,25,245,400,0,0
maksssksksss623.png,with_mask,188,94,211,117,23,23,245,400,0,0
maksssksksss623.png,with_mask,181,58,206,79,25,21,245,400,0,0
maksssksksss623.png,with_mask,185,28,208,46,23,18,245,400,0,0
maksssksksss623.png,with_mask,247,111,266,131,19,20,245,400,0,0
maksssksksss623.png,with_mask,254,56,275,78,21,22,245,400,0,0
maksssksksss623.png,with_mask,287,55,310,78,23,23,245,400,0,0
maksssksksss623.png,with_mask,359,149,387,167,28,18,245,400,0,0
maksssksksss623.png,with_mask,345,75,369,95,24,20,245,400,0,0
maksssksksss623.png,with_mask,320,41,338,59,18,18,245,400,0,0
maksssksksss623.png,with_mask,319,15,337,30,18,15,245,400,0,0
maksssksksss624.png,without_mask,95,195,193,338,98,143,400,301,0,0
maksssksksss625.png,with_mask,191,96,244,148,53,52,277,400,0,0
maksssksksss626.png,with_mask,69,100,214,267,145,167,400,267,0,0
maksssksksss627.png,without_mask,42,27,69,52,27,25,225,400,0,0
maksssksksss627.png,without_mask,132,5,144,20,12,15,225,400,0,0
maksssksksss627.png,without_mask,191,9,205,25,14,16,225,400,0,0
maksssksksss627.png,with_mask,204,14,225,39,21,25,225,400,0,0
maksssksksss627.png,without_mask,142,34,166,55,24,21,225,400,0,0
maksssksksss627.png,with_mask,130,63,161,96,31,33,225,400,0,0
maksssksksss627.png,without_mask,68,75,93,91,25,16,225,400,0,0
maksssksksss627.png,mask_weared_incorrect,36,167,63,194,27,27,225,400,0,0
maksssksksss627.png,mask_weared_incorrect,109,91,139,125,30,34,225,400,0,0
maksssksksss627.png,mask_weared_incorrect,169,77,213,121,44,44,225,400,0,0
maksssksksss627.png,without_mask,243,41,260,59,17,18,225,400,0,0
maksssksksss627.png,with_mask,256,44,282,72,26,28,225,400,0,0
maksssksksss627.png,with_mask,327,41,365,80,38,39,225,400,0,0
maksssksksss627.png,with_mask,263,132,310,182,47,50,225,400,0,0
maksssksksss628.png,with_mask,175,89,196,120,21,31,262,400,0,0
maksssksksss628.png,with_mask,70,93,81,104,11,11,262,400,0,0
maksssksksss629.png,with_mask,130,235,234,380,104,145,400,301,0,0
maksssksksss63.png,with_mask,131,86,259,216,128,130,226,400,0,0
maksssksksss630.png,with_mask,92,233,151,338,59,105,400,301,0,0
maksssksksss631.png,with_mask,4,50,20,66,16,16,209,400,0,0
maksssksksss631.png,with_mask,49,53,63,68,14,15,209,400,0,0
maksssksksss631.png,with_mask,85,55,100,70,15,15,209,400,0,0
maksssksksss631.png,with_mask,105,35,118,51,13,16,209,400,0,0
maksssksksss631.png,with_mask,127,43,141,60,14,17,209,400,0,0
maksssksksss631.png,with_mask,169,49,184,66,15,17,209,400,0,0
maksssksksss631.png,with_mask,220,47,234,63,14,16,209,400,0,0
maksssksksss631.png,with_mask,255,58,268,72,13,14,209,400,0,0
maksssksksss631.png,with_mask,291,56,305,71,14,15,209,400,0,0
maksssksksss631.png,with_mask,327,67,344,81,17,14,209,400,0,0
maksssksksss631.png,with_mask,373,58,391,75,18,17,209,400,0,0
maksssksksss632.png,with_mask,94,57,167,131,73,74,400,267,0,0
maksssksksss633.png,with_mask,269,138,324,190,55,52,400,400,0,0
maksssksksss634.png,mask_weared_incorrect,126,62,147,91,21,29,300,400,0,0
maksssksksss634.png,with_mask,184,91,201,115,17,24,300,400,0,0
maksssksksss634.png,with_mask,307,86,323,105,16,19,300,400,0,0
maksssksksss634.png,without_mask,370,95,381,108,11,13,300,400,0,0
maksssksksss635.png,with_mask,79,112,232,318,153,206,400,301,0,0
maksssksksss636.png,with_mask,76,94,99,121,23,27,300,400,0,0
maksssksksss636.png,with_mask,163,113,187,133,24,20,300,400,0,0
maksssksksss636.png,without_mask,229,93,243,108,14,15,300,400,0,0
maksssksksss636.png,without_mask,271,103,285,121,14,18,300,400,0,0
maksssksksss637.png,with_mask,37,36,55,54,18,18,226,400,0,0
maksssksksss637.png,with_mask,162,24,192,54,30,30,226,400,0,0
maksssksksss637.png,with_mask,176,109,202,127,26,18,226,400,0,0
maksssksksss637.png,with_mask,261,36,287,63,26,27,226,400,0,0
maksssksksss637.png,with_mask,312,33,329,45,17,12,226,400,0,0
maksssksksss637.png,with_mask,357,27,371,42,14,15,226,400,0,0
maksssksksss638.png,with_mask,53,100,108,158,55,58,264,400,0,0
maksssksksss638.png,with_mask,279,95,360,181,81,86,264,400,0,0
maksssksksss639.png,with_mask,32,35,89,96,57,61,226,400,0,0
maksssksksss639.png,with_mask,241,56,261,77,20,21,226,400,0,0
maksssksksss639.png,with_mask,336,47,367,80,31,33,226,400,0,0
maksssksksss639.png,with_mask,186,62,200,93,14,31,226,400,0,0
maksssksksss64.png,with_mask,99,44,116,64,17,20,225,400,0,0
maksssksksss64.png,with_mask,151,41,171,61,20,20,225,400,0,0
maksssksksss64.png,with_mask,306,21,326,42,20,21,225,400,0,0
maksssksksss640.png,with_mask,21,48,77,104,56,56,210,400,0,0
maksssksksss640.png,with_mask,118,84,163,131,45,47,210,400,0,0
maksssksksss640.png,with_mask,157,113,189,146,32,33,210,400,0,0
maksssksksss640.png,with_mask,172,65,202,95,30,30,210,400,0,0
maksssksksss640.png,with_mask,195,103,240,150,45,47,210,400,0,0
maksssksksss640.png,with_mask,260,129,302,173,42,44,210,400,0,0
maksssksksss640.png,with_mask,283,42,314,71,31,29,210,400,0,0
maksssksksss640.png,mask_weared_incorrect,364,84,399,121,35,37,210,400,0,0
maksssksksss641.png,without_mask,1,248,15,273,14,25,400,267,0,0
maksssksksss641.png,without_mask,12,240,36,269,24,29,400,267,0,0
maksssksksss641.png,without_mask,66,200,108,248,42,48,400,267,0,0
maksssksksss641.png,without_mask,216,272,257,318,41,46,400,267,0,0
maksssksksss642.png,with_mask,72,9,117,75,45,66,400,252,0,0
maksssksksss642.png,with_mask,138,100,182,158,44,58,400,252,0,0
maksssksksss643.png,with_mask,131,126,277,284,146,158,400,400,0,0
maksssksksss644.png,with_mask,52,198,172,337,120,139,400,301,0,0
maksssksksss645.png,with_mask,53,184,173,323,120,139,400,301,0,0
maksssksksss646.png,with_mask,91,188,201,334,110,146,400,301,0,0
maksssksksss647.png,mask_weared_incorrect,21,40,66,87,45,47,265,400,0,0
maksssksksss647.png,without_mask,82,21,108,43,26,22,265,400,0,0
maksssksksss647.png,with_mask,134,44,152,67,18,23,265,400,0,0
maksssksksss647.png,with_mask,150,75,182,109,32,34,265,400,0,0
maksssksksss647.png,with_mask,62,159,145,240,83,81,265,400,0,0
maksssksksss647.png,with_mask,186,142,264,223,78,81,265,400,0,0
maksssksksss647.png,with_mask,229,85,268,128,39,43,265,400,0,0
maksssksksss647.png,with_mask,186,52,214,82,28,30,265,400,0,0
maksssksksss647.png,without_mask,317,47,350,81,33,34,265,400,0,0
maksssksksss647.png,with_mask,361,23,397,53,36,30,265,400,0,0
maksssksksss647.png,with_mask,368,58,400,96,32,38,265,400,0,0
maksssksksss647.png,with_mask,294,123,339,172,45,49,265,400,0,0
maksssksksss648.png,with_mask,117,73,136,99,19,26,267,400,0,0
maksssksksss648.png,with_mask,194,24,225,62,31,38,267,400,0,0
maksssksksss648.png,with_mask,251,75,268,94,17,19,267,400,0,0
maksssksksss649.png,with_mask,144,252,233,383,89,131,400,301,0,0
maksssksksss65.png,with_mask,179,74,218,117,39,43,300,400,0,0
maksssksksss65.png,with_mask,264,96,294,141,30,45,300,400,0,0
maksssksksss65.png,without_mask,341,77,362,103,21,26,300,400,0,0
maksssksksss650.png,with_mask,108,73,155,134,47,61,400,267,0,0
maksssksksss651.png,with_mask,186,41,217,77,31,36,226,400,0,0
maksssksksss652.png,with_mask,30,184,142,327,112,143,400,301,0,0
maksssksksss653.png,with_mask,77,69,130,112,53,43,225,400,0,0
maksssksksss653.png,with_mask,280,54,329,99,49,45,225,400,0,0
maksssksksss654.png,with_mask,88,70,206,195,118,125,400,267,0,0
maksssksksss655.png,without_mask,107,175,209,292,102,117,400,301,0,0
maksssksksss656.png,with_mask,26,56,43,77,17,21,245,400,0,0
maksssksksss656.png,with_mask,57,69,77,87,20,18,245,400,0,0
maksssksksss656.png,with_mask,115,51,126,65,11,14,245,400,0,0
maksssksksss656.png,with_mask,133,61,152,85,19,24,245,400,0,0
maksssksksss656.png,with_mask,143,51,155,66,12,15,245,400,0,0
maksssksksss656.png,with_mask,155,59,171,78,16,19,245,400,0,0
maksssksksss656.png,with_mask,172,107,192,127,20,20,245,400,0,0
maksssksksss656.png,with_mask,186,60,197,75,11,15,245,400,0,0
maksssksksss656.png,with_mask,205,58,217,75,12,17,245,400,0,0
maksssksksss656.png,with_mask,216,58,233,78,17,20,245,400,0,0
maksssksksss656.png,with_mask,238,67,253,83,15,16,245,400,0,0
maksssksksss656.png,with_mask,253,72,268,91,15,19,245,400,0,0
maksssksksss656.png,with_mask,275,77,296,97,21,20,245,400,0,0
maksssksksss656.png,with_mask,301,55,315,72,14,17,245,400,0,0
maksssksksss656.png,without_mask,316,56,330,71,14,15,245,400,0,0
maksssksksss656.png,with_mask,345,51,361,67,16,16,245,400,0,0
maksssksksss656.png,with_mask,366,54,385,73,19,19,245,400,0,0
maksssksksss657.png,with_mask,26,58,40,74,14,16,267,400,0,0
maksssksksss657.png,with_mask,61,58,77,77,16,19,267,400,0,0
maksssksksss657.png,without_mask,84,48,95,59,11,11,267,400,0,0
maksssksksss657.png,without_mask,94,35,110,50,16,15,267,400,0,0
maksssksksss657.png,without_mask,133,44,151,61,18,17,267,400,0,0
maksssksksss657.png,with_mask,191,51,212,76,21,25,267,400,0,0
maksssksksss657.png,without_mask,231,39,248,57,17,18,267,400,0,0
maksssksksss657.png,mask_weared_incorrect,255,36,273,54,18,18,267,400,0,0
maksssksksss657.png,with_mask,318,26,341,53,23,27,267,400,0,0
maksssksksss657.png,with_mask,295,28,306,40,11,12,267,400,0,0
maksssksksss657.png,without_mask,18,38,30,52,12,14,267,400,0,0
maksssksksss658.png,mask_weared_incorrect,121,47,158,80,37,33,400,267,0,0
maksssksksss659.png,mask_weared_incorrect,113,97,252,251,139,154,575,441,0,0
maksssksksss66.png,with_mask,179,81,267,173,88,92,400,380,0,0
maksssksksss660.png,without_mask,132,141,232,264,100,123,400,301,0,0
maksssksksss661.png,with_mask,11,63,30,81,19,18,261,400,0,0
maksssksksss661.png,with_mask,67,58,83,74,16,16,261,400,0,0
maksssksksss661.png,with_mask,100,59,114,76,14,17,261,400,0,0
maksssksksss661.png,with_mask,156,55,172,72,16,17,261,400,0,0
maksssksksss661.png,with_mask,176,54,188,68,12,14,261,400,0,0
maksssksksss661.png,with_mask,190,52,202,68,12,16,261,400,0,0
maksssksksss661.png,with_mask,198,66,213,82,15,16,261,400,0,0
maksssksksss661.png,with_mask,220,81,243,104,23,23,261,400,0,0
maksssksksss661.png,without_mask,261,46,279,65,18,19,261,400,0,0
maksssksksss661.png,with_mask,266,84,290,112,24,28,261,400,0,0
maksssksksss661.png,with_mask,317,41,332,57,15,16,261,400,0,0
maksssksksss661.png,with_mask,311,82,332,100,21,18,261,400,0,0
maksssksksss661.png,with_mask,352,101,384,137,32,36,261,400,0,0
maksssksksss661.png,without_mask,340,101,354,121,14,20,261,400,0,0
maksssksksss662.png,with_mask,49,80,67,97,18,17,261,400,0,0
maksssksksss662.png,with_mask,96,47,110,62,14,15,261,400,0,0
maksssksksss662.png,with_mask,213,57,230,77,17,20,261,400,0,0
maksssksksss662.png,with_mask,350,43,372,67,22,24,261,400,0,0
maksssksksss663.png,with_mask,69,194,152,302,83,108,400,301,0,0
maksssksksss664.png,with_mask,110,70,176,140,66,70,400,259,0,0
maksssksksss665.png,with_mask,1,162,76,251,75,89,267,400,0,0
maksssksksss665.png,with_mask,49,88,86,140,37,52,267,400,0,0
maksssksksss665.png,with_mask,63,47,107,101,44,54,267,400,0,0
maksssksksss665.png,with_mask,118,94,172,156,54,62,267,400,0,0
maksssksksss665.png,with_mask,187,121,267,201,80,80,267,400,0,0
maksssksksss665.png,with_mask,252,21,293,69,41,48,267,400,0,0
maksssksksss665.png,with_mask,339,16,369,74,30,58,267,400,0,0
maksssksksss665.png,with_mask,325,138,389,201,64,63,267,400,0,0
maksssksksss666.png,with_mask,21,12,103,114,82,102,300,400,0,0
maksssksksss666.png,with_mask,188,100,283,204,95,104,300,400,0,0
maksssksksss666.png,mask_weared_incorrect,298,2,398,91,100,89,300,400,0,0
maksssksksss667.png,with_mask,6,56,70,127,64,71,225,400,0,0
maksssksksss667.png,with_mask,286,68,348,139,62,71,225,400,0,0
maksssksksss667.png,with_mask,344,79,400,137,56,58,225,400,0,0
maksssksksss668.png,with_mask,38,248,111,354,73,106,400,301,0,0
maksssksksss669.png,with_mask,60,121,219,301,159,180,400,300,0,0
maksssksksss67.png,with_mask,78,58,92,75,14,17,300,400,0,0
maksssksksss67.png,with_mask,153,48,167,65,14,17,300,400,0,0
maksssksksss67.png,with_mask,234,68,247,86,13,18,300,400,0,0
maksssksksss67.png,with_mask,292,64,305,86,13,22,300,400,0,0
maksssksksss670.png,with_mask,159,55,194,94,35,39,225,400,0,0
maksssksksss670.png,with_mask,219,89,245,120,26,31,225,400,0,0
maksssksksss670.png,with_mask,137,114,172,142,35,28,225,400,0,0
maksssksksss670.png,with_mask,311,86,327,105,16,19,225,400,0,0
maksssksksss671.png,with_mask,54,180,164,327,110,147,400,301,0,0
maksssksksss672.png,with_mask,159,110,193,148,34,38,300,400,0,0
maksssksksss672.png,with_mask,214,168,246,205,32,37,300,400,0,0
maksssksksss672.png,with_mask,29,150,55,183,26,33,300,400,0,0
maksssksksss672.png,with_mask,341,118,376,156,35,38,300,400,0,0
maksssksksss672.png,mask_weared_incorrect,240,143,277,186,37,43,300,400,0,0
maksssksksss672.png,without_mask,51,221,96,263,45,42,300,400,0,0
maksssksksss672.png,without_mask,1,50,27,78,26,28,300,400,0,0
maksssksksss672.png,without_mask,133,47,159,76,26,29,300,400,0,0
maksssksksss672.png,without_mask,354,266,397,300,43,34,300,400,0,0
maksssksksss673.png,with_mask,32,165,67,202,35,37,290,400,0,0
maksssksksss673.png,with_mask,171,193,204,229,33,36,290,400,0,0
maksssksksss673.png,mask_weared_incorrect,279,172,313,213,34,41,290,400,0,0
maksssksksss673.png,without_mask,102,199,118,220,16,21,290,400,0,0
maksssksksss673.png,without_mask,240,189,258,210,18,21,290,400,0,0
maksssksksss674.png,with_mask,24,60,44,83,20,23,225,400,0,0
maksssksksss674.png,with_mask,58,75,76,95,18,20,225,400,0,0
maksssksksss674.png,with_mask,130,67,152,92,22,25,225,400,0,0
maksssksksss674.png,with_mask,154,65,171,83,17,18,225,400,0,0
maksssksksss674.png,with_mask,171,116,192,138,21,22,225,400,0,0
maksssksksss674.png,with_mask,205,62,217,80,12,18,225,400,0,0
maksssksksss674.png,with_mask,216,63,234,84,18,21,225,400,0,0
maksssksksss674.png,with_mask,237,72,254,90,17,18,225,400,0,0
maksssksksss674.png,with_mask,252,79,269,99,17,20,225,400,0,0
maksssksksss674.png,with_mask,274,82,297,106,23,24,225,400,0,0
maksssksksss674.png,with_mask,300,60,314,77,14,17,225,400,0,0
maksssksksss674.png,without_mask,316,61,331,76,15,15,225,400,0,0
maksssksksss674.png,with_mask,345,54,362,74,17,20,225,400,0,0
maksssksksss674.png,with_mask,366,58,386,80,20,22,225,400,0,0
maksssksksss674.png,with_mask,113,55,127,72,14,17,225,400,0,0
maksssksksss674.png,with_mask,184,66,198,81,14,15,225,400,0,0
maksssksksss674.png,with_mask,140,56,155,71,15,15,225,400,0,0
maksssksksss675.png,with_mask,104,138,218,276,114,138,400,301,0,0
maksssksksss676.png,with_mask,20,124,49,158,29,34,267,400,0,0
maksssksksss676.png,with_mask,34,219,73,267,39,48,267,400,0,0
maksssksksss676.png,with_mask,88,154,114,187,26,33,267,400,0,0
maksssksksss676.png,with_mask,107,99,124,119,17,20,267,400,0,0
maksssksksss676.png,with_mask,133,84,148,105,15,21,267,400,0,0
maksssksksss676.png,with_mask,192,112,210,135,18,23,267,400,0,0
maksssksksss676.png,with_mask,215,82,231,103,16,21,267,400,0,0
maksssksksss676.png,with_mask,264,108,279,125,15,17,267,400,0,0
maksssksksss676.png,with_mask,302,120,316,141,14,21,267,400,0,0
maksssksksss676.png,with_mask,340,142,356,172,16,30,267,400,0,0
maksssksksss676.png,with_mask,232,72,249,94,17,22,267,400,0,0
maksssksksss677.png,with_mask,237,28,271,64,34,36,300,400,0,0
maksssksksss678.png,with_mask,188,50,227,89,39,39,225,400,0,0
maksssksksss678.png,with_mask,363,104,389,139,26,35,225,400,0,0
maksssksksss679.png,with_mask,125,66,200,148,75,82,225,400,0,0
maksssksksss68.png,without_mask,141,187,237,307,96,120,400,301,0,0
maksssksksss680.png,with_mask,28,76,44,101,16,25,267,400,0,0
maksssksksss680.png,with_mask,159,66,176,86,17,20,267,400,0,0
maksssksksss680.png,with_mask,174,34,186,53,12,19,267,400,0,0
maksssksksss680.png,with_mask,202,39,218,61,16,22,267,400,0,0
maksssksksss680.png,without_mask,235,41,249,57,14,16,267,400,0,0
maksssksksss680.png,mask_weared_incorrect,249,43,266,65,17,22,267,400,0,0
maksssksksss680.png,with_mask,296,39,312,56,16,17,267,400,0,0
maksssksksss680.png,with_mask,332,51,346,69,14,18,267,400,0,0
maksssksksss680.png,with_mask,375,48,388,63,13,15,267,400,0,0
maksssksksss680.png,mask_weared_incorrect,387,46,400,65,13,19,267,400,0,0
maksssksksss681.png,with_mask,81,174,222,331,141,157,400,301,0,0
maksssksksss682.png,with_mask,69,80,107,114,38,34,277,400,0,0
maksssksksss682.png,with_mask,191,73,221,106,30,33,277,400,0,0
maksssksksss682.png,with_mask,311,80,346,110,35,30,277,400,0,0
maksssksksss682.png,without_mask,3,53,23,77,20,24,277,400,0,0
maksssksksss682.png,with_mask,108,49,134,67,26,18,277,400,0,0
maksssksksss683.png,with_mask,96,87,216,214,120,127,400,300,0,0
maksssksksss684.png,with_mask,80,55,102,80,22,25,269,400,0,0
maksssksksss684.png,with_mask,174,71,192,90,18,19,269,400,0,0
maksssksksss684.png,with_mask,228,79,243,98,15,19,269,400,0,0
maksssksksss684.png,without_mask,282,75,296,90,14,15,269,400,0,0
maksssksksss685.png,with_mask,12,37,54,79,42,42,225,400,0,0
maksssksksss685.png,with_mask,147,47,197,103,50,56,225,400,0,0
maksssksksss685.png,with_mask,292,55,315,80,23,25,225,400,0,0
maksssksksss685.png,with_mask,381,56,400,77,19,21,225,400,0,0
maksssksksss686.png,with_mask,54,173,158,299,104,126,400,301,0,0
maksssksksss687.png,with_mask,57,211,168,353,111,142,400,301,0,0
maksssksksss688.png,with_mask,166,67,260,160,94,93,277,400,0,0
maksssksksss689.png,with_mask,293,153,361,212,68,59,315,560,0,0
maksssksksss69.png,with_mask,145,93,280,241,135,148,351,400,0,0
maksssksksss690.png,with_mask,25,54,43,76,18,22,245,400,0,0
maksssksksss690.png,with_mask,58,67,76,88,18,21,245,400,0,0
maksssksksss690.png,with_mask,132,62,152,85,20,23,245,400,0,0
maksssksksss690.png,with_mask,115,51,127,65,12,14,245,400,0,0
maksssksksss690.png,with_mask,143,52,154,63,11,11,245,400,0,0
maksssksksss690.png,with_mask,154,61,172,77,18,16,245,400,0,0
maksssksksss690.png,with_mask,173,106,192,127,19,21,245,400,0,0
maksssksksss690.png,with_mask,186,60,198,74,12,14,245,400,0,0
maksssksksss690.png,with_mask,205,58,217,74,12,16,245,400,0,0
maksssksksss690.png,with_mask,216,59,233,78,17,19,245,400,0,0
maksssksksss690.png,with_mask,238,66,254,84,16,18,245,400,0,0
maksssksksss690.png,with_mask,252,71,271,93,19,22,245,400,0,0
maksssksksss690.png,with_mask,275,75,297,99,22,24,245,400,0,0
maksssksksss690.png,with_mask,282,44,294,61,12,17,245,400,0,0
maksssksksss690.png,with_mask,299,55,316,73,17,18,245,400,0,0
maksssksksss690.png,without_mask,316,57,332,71,16,14,245,400,0,0
maksssksksss690.png,with_mask,345,50,362,67,17,17,245,400,0,0
maksssksksss690.png,with_mask,366,53,385,73,19,20,245,400,0,0
maksssksksss691.png,with_mask,316,105,360,134,44,29,267,400,0,0
maksssksksss691.png,with_mask,258,75,287,110,29,35,267,400,0,0
maksssksksss691.png,with_mask,232,74,261,105,29,31,267,400,0,0
maksssksksss691.png,with_mask,204,64,232,93,28,29,267,400,0,0
maksssksksss691.png,with_mask,163,66,188,94,25,28,267,400,0,0
maksssksksss691.png,with_mask,152,62,166,89,14,27,267,400,0,0
maksssksksss691.png,with_mask,138,67,152,90,14,23,267,400,0,0
maksssksksss691.png,with_mask,112,43,134,67,22,24,267,400,0,0
maksssksksss691.png,with_mask,94,56,116,78,22,22,267,400,0,0
maksssksksss691.png,with_mask,42,64,55,79,13,15,267,400,0,0
maksssksksss691.png,with_mask,3,54,18,72,15,18,267,400,0,0
maksssksksss692.png,with_mask,73,227,161,335,88,108,400,301,0,0
maksssksksss693.png,mask_weared_incorrect,156,47,183,80,27,33,400,279,0,0
maksssksksss693.png,with_mask,90,39,123,72,33,33,400,279,0,0
maksssksksss694.png,with_mask,101,81,117,97,16,16,280,400,0,0
maksssksksss694.png,with_mask,155,101,169,116,14,15,280,400,0,0
maksssksksss694.png,with_mask,294,104,307,120,13,16,280,400,0,0
maksssksksss695.png,with_mask,297,174,337,215,40,41,267,400,0,0
maksssksksss695.png,without_mask,319,125,350,156,31,31,267,400,0,0
maksssksksss695.png,without_mask,164,134,195,165,31,31,267,400,0,0
maksssksksss695.png,with_mask,189,167,230,206,41,39,267,400,0,0
maksssksksss695.png,with_mask,372,135,396,158,24,23,267,400,0,0
maksssksksss695.png,with_mask,59,148,92,189,33,41,267,400,0,0
maksssksksss695.png,with_mask,20,124,42,148,22,24,267,400,0,0
maksssksksss695.png,with_mask,98,143,116,170,18,27,267,400,0,0
maksssksksss695.png,with_mask,131,132,152,153,21,21,267,400,0,0
maksssksksss695.png,with_mask,146,117,169,146,23,29,267,400,0,0
maksssksksss695.png,with_mask,196,118,220,143,24,25,267,400,0,0
maksssksksss695.png,with_mask,220,121,236,140,16,19,267,400,0,0
maksssksksss695.png,with_mask,240,98,252,113,12,15,267,400,0,0
maksssksksss695.png,with_mask,283,89,300,103,17,14,267,400,0,0
maksssksksss695.png,without_mask,112,122,128,142,16,20,267,400,0,0
maksssksksss695.png,with_mask,42,103,56,118,14,15,267,400,0,0
maksssksksss695.png,with_mask,141,95,159,113,18,18,267,400,0,0
maksssksksss695.png,without_mask,183,84,196,98,13,14,267,400,0,0
maksssksksss695.png,with_mask,268,93,282,106,14,13,267,400,0,0
maksssksksss695.png,with_mask,226,107,238,122,12,15,267,400,0,0
maksssksksss696.png,with_mask,41,104,58,120,17,16,269,400,0,0
maksssksksss696.png,with_mask,109,44,131,69,22,25,269,400,0,0
maksssksksss696.png,with_mask,149,67,166,86,17,19,269,400,0,0
maksssksksss696.png,with_mask,167,83,181,102,14,19,269,400,0,0
maksssksksss696.png,with_mask,206,77,224,97,18,20,269,400,0,0
maksssksksss696.png,without_mask,340,77,355,95,15,18,269,400,0,0
maksssksksss697.png,with_mask,39,83,149,216,110,133,300,400,0,0
maksssksksss697.png,with_mask,239,95,368,235,129,140,300,400,0,0
maksssksksss698.png,with_mask,169,168,234,243,65,75,333,400,0,0
maksssksksss698.png,with_mask,352,66,400,131,48,65,333,400,0,0
maksssksksss698.png,mask_weared_incorrect,1,136,37,182,36,46,333,400,0,0
maksssksksss698.png,mask_weared_incorrect,317,214,353,248,36,34,333,400,0,0
maksssksksss698.png,mask_weared_incorrect,275,61,318,107,43,46,333,400,0,0
maksssksksss698.png,without_mask,28,109,55,147,27,38,333,400,0,0
maksssksksss698.png,without_mask,328,87,356,135,28,48,333,400,0,0
maksssksksss699.png,without_mask,18,82,64,131,46,49,279,400,0,0
maksssksksss699.png,without_mask,18,198,66,245,48,47,279,400,0,0
maksssksksss699.png,with_mask,237,136,288,186,51,50,279,400,0,0
maksssksksss699.png,without_mask,113,47,148,73,35,26,279,400,0,0
maksssksksss699.png,without_mask,278,17,320,68,42,51,279,400,0,0
maksssksksss699.png,without_mask,340,98,383,139,43,41,279,400,0,0
maksssksksss699.png,without_mask,342,217,396,256,54,39,279,400,0,0
maksssksksss7.png,with_mask,253,116,342,210,89,94,300,400,0,0
maksssksksss7.png,with_mask,152,96,222,174,70,78,300,400,0,0
maksssksksss7.png,with_mask,120,134,173,194,53,60,300,400,0,0
maksssksksss7.png,without_mask,118,66,135,90,17,24,300,400,0,0
maksssksksss70.png,without_mask,18,117,45,145,27,28,225,400,0,0
maksssksksss70.png,without_mask,62,120,85,143,23,23,225,400,0,0
maksssksksss70.png,without_mask,96,128,120,157,24,29,225,400,0,0
maksssksksss70.png,with_mask,152,71,203,126,51,55,225,400,0,0
maksssksksss70.png,with_mask,326,117,353,144,27,27,225,400,0,0
maksssksksss700.png,with_mask,63,124,96,160,33,36,400,225,0,0
maksssksksss700.png,with_mask,152,129,181,164,29,35,400,225,0,0
maksssksksss701.png,without_mask,98,150,199,265,101,115,400,301,0,0
maksssksksss702.png,with_mask,9,170,60,229,51,59,317,600,0,0
maksssksksss702.png,with_mask,165,90,202,124,37,34,317,600,0,0
maksssksksss702.png,with_mask,175,175,244,260,69,85,317,600,0,0
maksssksksss702.png,with_mask,303,127,360,191,57,64,317,600,0,0
maksssksksss702.png,mask_weared_incorrect,340,66,380,111,40,45,317,600,0,0
maksssksksss702.png,with_mask,379,63,408,98,29,35,317,600,0,0
maksssksksss702.png,with_mask,433,61,471,105,38,44,317,600,0,0
maksssksksss702.png,with_mask,477,78,536,133,59,55,317,600,0,0
maksssksksss702.png,with_mask,569,37,592,67,23,30,317,600,0,0
maksssksksss702.png,with_mask,367,192,437,259,70,67,317,600,0,0
maksssksksss702.png,without_mask,221,57,248,81,27,24,317,600,0,0
maksssksksss703.png,with_mask,17,85,59,129,42,44,267,400,0,0
maksssksksss703.png,without_mask,67,94,96,125,29,31,267,400,0,0
maksssksksss703.png,without_mask,96,167,139,208,43,41,267,400,0,0
maksssksksss703.png,with_mask,174,91,207,128,33,37,267,400,0,0
maksssksksss703.png,with_mask,212,69,238,100,26,31,267,400,0,0
maksssksksss703.png,without_mask,247,78,285,107,38,29,267,400,0,0
maksssksksss703.png,with_mask,312,82,331,112,19,30,267,400,0,0
maksssksksss703.png,with_mask,331,93,371,135,40,42,267,400,0,0
maksssksksss703.png,without_mask,384,116,400,156,16,40,267,400,0,0
maksssksksss703.png,with_mask,280,197,331,241,51,44,267,400,0,0
maksssksksss704.png,with_mask,1,162,74,246,73,84,267,400,0,0
maksssksksss704.png,with_mask,49,87,85,138,36,51,267,400,0,0
maksssksksss704.png,with_mask,114,92,172,156,58,64,267,400,0,0
maksssksksss704.png,with_mask,65,45,107,101,42,56,267,400,0,0
maksssksksss704.png,with_mask,187,120,268,202,81,82,267,400,0,0
maksssksksss704.png,with_mask,252,22,296,71,44,49,267,400,0,0
maksssksksss704.png,with_mask,338,15,380,74,42,59,267,400,0,0
maksssksksss704.png,with_mask,329,138,390,204,61,66,267,400,0,0
maksssksksss705.png,with_mask,8,15,36,45,28,30,225,400,0,0
maksssksksss705.png,with_mask,53,19,86,50,33,31,225,400,0,0
maksssksksss705.png,with_mask,59,77,94,111,35,34,225,400,0,0
maksssksksss705.png,with_mask,27,155,58,186,31,31,225,400,0,0
maksssksksss705.png,with_mask,110,86,144,123,34,37,225,400,0,0
maksssksksss705.png,with_mask,104,170,135,197,31,27,225,400,0,0
maksssksksss705.png,with_mask,190,119,225,159,35,40,225,400,0,0
maksssksksss705.png,with_mask,197,185,229,222,32,37,225,400,0,0
maksssksksss705.png,with_mask,225,112,256,145,31,33,225,400,0,0
maksssksksss705.png,with_mask,279,157,310,194,31,37,225,400,0,0
maksssksksss705.png,with_mask,323,55,355,90,32,35,225,400,0,0
maksssksksss705.png,with_mask,377,28,400,55,23,27,225,400,0,0
maksssksksss705.png,with_mask,374,79,400,113,26,34,225,400,0,0
maksssksksss705.png,with_mask,320,123,351,159,31,36,225,400,0,0
maksssksksss705.png,with_mask,360,142,397,179,37,37,225,400,0,0
maksssksksss705.png,with_mask,309,191,344,225,35,34,225,400,0,0
maksssksksss706.png,with_mask,22,128,67,174,45,46,267,400,0,0
maksssksksss706.png,with_mask,58,192,107,245,49,53,267,400,0,0
maksssksksss706.png,with_mask,114,113,140,141,26,28,267,400,0,0
maksssksksss706.png,with_mask,86,119,106,137,20,18,267,400,0,0
maksssksksss706.png,with_mask,113,83,132,103,19,20,267,400,0,0
maksssksksss706.png,with_mask,159,89,177,114,18,25,267,400,0,0
maksssksksss706.png,with_mask,147,86,159,99,12,13,267,400,0,0
maksssksksss706.png,with_mask,178,118,206,150,28,32,267,400,0,0
maksssksksss706.png,with_mask,236,89,263,121,27,32,267,400,0,0
maksssksksss706.png,with_mask,300,81,320,106,20,25,267,400,0,0
maksssksksss706.png,with_mask,287,142,324,179,37,37,267,400,0,0
maksssksksss706.png,with_mask,315,210,374,264,59,54,267,400,0,0
maksssksksss706.png,with_mask,349,92,365,111,16,19,267,400,0,0
maksssksksss706.png,with_mask,372,113,391,131,19,18,267,400,0,0
maksssksksss706.png,with_mask,267,103,284,122,17,19,267,400,0,0
maksssksksss706.png,with_mask,375,89,390,101,15,12,267,400,0,0
maksssksksss707.png,with_mask,64,161,183,323,119,162,400,301,0,0
maksssksksss708.png,with_mask,1,39,54,137,53,98,230,400,0,0
maksssksksss708.png,with_mask,134,62,198,138,64,76,230,400,0,0
maksssksksss708.png,with_mask,209,59,276,134,67,75,230,400,0,0
maksssksksss709.png,with_mask,49,183,139,294,90,111,400,301,0,0
maksssksksss71.png,without_mask,133,29,173,56,40,27,225,400,0,0
maksssksksss71.png,with_mask,30,52,74,94,44,42,225,400,0,0
maksssksksss71.png,with_mask,18,119,83,191,65,72,225,400,0,0
maksssksksss71.png,with_mask,140,70,191,124,51,54,225,400,0,0
maksssksksss71.png,with_mask,230,63,344,171,114,108,225,400,0,0
maksssksksss71.png,with_mask,375,50,400,116,25,66,225,400,0,0
maksssksksss710.png,without_mask,55,31,80,62,25,31,200,400,0,0
maksssksksss710.png,with_mask,132,61,183,124,51,63,200,400,0,0
maksssksksss710.png,with_mask,232,57,279,108,47,51,200,400,0,0
maksssksksss711.png,with_mask,30,48,46,66,16,18,283,400,0,0
maksssksksss711.png,with_mask,87,52,101,67,14,15,283,400,0,0
maksssksksss711.png,with_mask,186,43,208,67,22,24,283,400,0,0
maksssksksss711.png,with_mask,199,110,217,125,18,15,283,400,0,0
maksssksksss711.png,with_mask,264,52,283,74,19,22,283,400,0,0
maksssksksss711.png,with_mask,305,50,319,62,14,12,283,400,0,0
maksssksksss711.png,with_mask,340,45,351,56,11,11,283,400,0,0
maksssksksss711.png,with_mask,369,53,383,65,14,12,283,400,0,0
maksssksksss712.png,with_mask,90,213,171,321,81,108,400,301,0,0
maksssksksss713.png,with_mask,244,70,348,183,104,113,289,400,0,0
maksssksksss714.png,with_mask,78,139,108,174,30,35,300,400,0,0
maksssksksss714.png,with_mask,180,155,206,182,26,27,300,400,0,0
maksssksksss714.png,with_mask,305,189,326,212,21,23,300,400,0,0
maksssksksss714.png,with_mask,375,124,400,157,25,33,300,400,0,0
maksssksksss715.png,with_mask,81,168,127,221,46,53,400,267,0,0
maksssksksss715.png,without_mask,1,169,24,228,23,59,400,267,0,0
maksssksksss716.png,without_mask,101,174,209,299,108,125,400,301,0,0
maksssksksss717.png,mask_weared_incorrect,1,95,76,172,75,77,287,510,0,0
maksssksksss717.png,without_mask,76,128,142,185,66,57,287,510,0,0
maksssksksss717.png,with_mask,231,85,278,159,47,74,287,510,0,0
maksssksksss717.png,with_mask,297,91,376,169,79,78,287,510,0,0
maksssksksss718.png,with_mask,61,39,96,95,35,56,267,400,0,0
maksssksksss718.png,with_mask,90,49,136,110,46,61,267,400,0,0
maksssksksss718.png,with_mask,157,50,193,103,36,53,267,400,0,0
maksssksksss718.png,with_mask,205,73,233,113,28,40,267,400,0,0
maksssksksss718.png,with_mask,251,42,274,82,23,40,267,400,0,0
maksssksksss718.png,with_mask,285,71,311,104,26,33,267,400,0,0
maksssksksss718.png,mask_weared_incorrect,312,69,328,98,16,29,267,400,0,0
maksssksksss718.png,with_mask,322,61,335,86,13,25,267,400,0,0
maksssksksss718.png,with_mask,342,75,357,95,15,20,267,400,0,0
maksssksksss719.png,with_mask,25,86,40,104,15,18,226,400,0,0
maksssksksss719.png,with_mask,52,86,80,108,28,22,226,400,0,0
maksssksksss719.png,with_mask,151,81,171,108,20,27,226,400,0,0
maksssksksss719.png,with_mask,229,81,259,111,30,30,226,400,0,0
maksssksksss719.png,with_mask,307,61,343,103,36,42,226,400,0,0
maksssksksss72.png,without_mask,112,176,207,291,95,115,400,301,0,0
maksssksksss720.png,with_mask,39,73,71,141,32,68,221,400,0,0
maksssksksss720.png,with_mask,90,110,135,170,45,60,221,400,0,0
maksssksksss720.png,with_mask,175,73,230,127,55,54,221,400,0,0
maksssksksss720.png,with_mask,238,100,290,164,52,64,221,400,0,0
maksssksksss720.png,with_mask,327,36,366,76,39,40,221,400,0,0
maksssksksss721.png,with_mask,102,200,200,330,98,130,400,301,0,0
maksssksksss722.png,with_mask,19,89,37,107,18,18,267,400,0,0
maksssksksss722.png,with_mask,45,79,64,103,19,24,267,400,0,0
maksssksksss722.png,with_mask,97,81,113,101,16,20,267,400,0,0
maksssksksss722.png,with_mask,175,80,193,103,18,23,267,400,0,0
maksssksksss722.png,with_mask,158,83,170,99,12,16,267,400,0,0
maksssksksss722.png,with_mask,210,93,224,108,14,15,267,400,0,0
maksssksksss722.png,with_mask,269,87,286,104,17,17,267,400,0,0
maksssksksss722.png,with_mask,308,88,322,103,14,15,267,400,0,0
maksssksksss723.png,with_mask,117,153,162,200,45,47,226,400,0,0
maksssksksss723.png,with_mask,204,20,221,41,17,21,226,400,0,0
maksssksksss723.png,without_mask,282,17,307,40,25,23,226,400,0,0
maksssksksss723.png,with_mask,243,74,264,98,21,24,226,400,0,0
maksssksksss723.png,with_mask,141,30,156,53,15,23,226,400,0,0
maksssksksss724.png,with_mask,303,24,328,53,25,29,300,400,0,0
maksssksksss725.png,with_mask,45,215,138,336,93,121,400,301,0,0
maksssksksss726.png,without_mask,188,67,207,89,19,22,254,400,0,0
maksssksksss726.png,with_mask,256,63,277,85,21,22,254,400,0,0
maksssksksss726.png,without_mask,312,89,325,105,13,16,254,400,0,0
maksssksksss726.png,without_mask,356,77,369,96,13,19,254,400,0,0
maksssksksss727.png,with_mask,64,176,166,301,102,125,400,301,0,0
maksssksksss728.png,with_mask,41,57,57,74,16,17,266,400,0,0
maksssksksss728.png,with_mask,104,45,120,63,16,18,266,400,0,0
maksssksksss728.png,with_mask,188,60,202,73,14,13,266,400,0,0
maksssksksss728.png,with_mask,263,84,278,102,15,18,266,400,0,0
maksssksksss728.png,mask_weared_incorrect,349,71,363,86,14,15,266,400,0,0
maksssksksss728.png,with_mask,381,82,395,100,14,18,266,400,0,0
maksssksksss729.png,without_mask,89,284,176,400,87,116,400,301,0,0
maksssksksss73.png,with_mask,142,66,164,111,22,45,286,400,0,0
maksssksksss73.png,with_mask,191,67,225,101,34,34,286,400,0,0
maksssksksss73.png,with_mask,308,82,329,127,21,45,286,400,0,0
maksssksksss730.png,with_mask,146,106,157,123,11,17,267,400,0,0
maksssksksss730.png,with_mask,192,75,205,95,13,20,267,400,0,0
maksssksksss730.png,with_mask,243,122,256,141,13,19,267,400,0,0
maksssksksss731.png,with_mask,93,136,136,181,43,45,400,400,0,0
maksssksksss731.png,with_mask,248,93,309,163,61,70,400,400,0,0
maksssksksss732.png,with_mask,291,47,323,83,32,36,268,400,0,0
maksssksksss732.png,with_mask,347,51,359,66,12,15,268,400,0,0
maksssksksss732.png,with_mask,230,49,259,79,29,30,268,400,0,0
maksssksksss732.png,with_mask,197,49,221,79,24,30,268,400,0,0
maksssksksss732.png,with_mask,151,46,175,68,24,22,268,400,0,0
maksssksksss732.png,with_mask,107,47,129,72,22,25,268,400,0,0
maksssksksss732.png,without_mask,59,54,75,74,16,20,268,400,0,0
maksssksksss732.png,without_mask,39,63,57,84,18,21,268,400,0,0
maksssksksss733.png,with_mask,143,72,271,199,128,127,295,400,0,0
maksssksksss734.png,with_mask,93,44,150,100,57,56,225,400,0,0
maksssksksss735.png,with_mask,3,29,49,79,46,50,225,400,0,0
maksssksksss735.png,with_mask,121,68,152,103,31,35,225,400,0,0
maksssksksss735.png,with_mask,164,40,178,60,14,20,225,400,0,0
maksssksksss735.png,with_mask,195,39,222,70,27,31,225,400,0,0
maksssksksss735.png,with_mask,352,52,367,68,15,16,225,400,0,0
maksssksksss735.png,without_mask,379,54,392,71,13,17,225,400,0,0
maksssksksss735.png,without_mask,305,46,322,65,17,19,225,400,0,0
maksssksksss735.png,without_mask,281,44,296,63,15,19,225,400,0,0
maksssksksss735.png,without_mask,249,42,266,67,17,25,225,400,0,0
maksssksksss735.png,without_mask,75,47,97,69,22,22,225,400,0,0
maksssksksss736.png,with_mask,114,40,142,76,28,36,400,267,0,0
maksssksksss736.png,with_mask,183,57,221,99,38,42,400,267,0,0
maksssksksss737.png,with_mask,28,55,46,71,18,16,226,400,0,0
maksssksksss737.png,with_mask,98,62,111,78,13,16,226,400,0,0
maksssksksss737.png,mask_weared_incorrect,159,50,193,90,34,40,226,400,0,0
maksssksksss737.png,with_mask,293,59,313,80,20,21,226,400,0,0
maksssksksss737.png,with_mask,352,51,372,72,20,21,226,400,0,0
maksssksksss737.png,with_mask,228,53,241,73,13,20,226,400,0,0
maksssksksss738.png,with_mask,82,43,123,83,41,40,267,400,0,0
maksssksksss738.png,with_mask,211,27,244,70,33,43,267,400,0,0
maksssksksss739.png,with_mask,125,59,184,114,59,55,226,400,0,0
maksssksksss74.png,with_mask,2,160,36,197,34,37,301,400,0,0
maksssksksss74.png,with_mask,27,120,43,138,16,18,301,400,0,0
maksssksksss74.png,with_mask,44,112,55,125,11,13,301,400,0,0
maksssksksss74.png,with_mask,72,123,87,136,15,13,301,400,0,0
maksssksksss74.png,with_mask,89,103,100,115,11,12,301,400,0,0
maksssksksss74.png,with_mask,92,135,138,184,46,49,301,400,0,0
maksssksksss74.png,with_mask,169,128,186,146,17,18,301,400,0,0
maksssksksss74.png,with_mask,205,121,230,147,25,26,301,400,0,0
maksssksksss74.png,with_mask,321,125,340,144,19,19,301,400,0,0
maksssksksss740.png,with_mask,143,60,168,89,25,29,264,400,0,0
maksssksksss740.png,with_mask,275,52,299,80,24,28,264,400,0,0
maksssksksss741.png,mask_weared_incorrect,111,40,151,77,40,37,400,267,0,0
maksssksksss742.png,with_mask,152,151,256,300,104,149,400,301,0,0
maksssksksss743.png,with_mask,111,166,199,280,88,114,400,301,0,0
maksssksksss744.png,with_mask,83,81,112,113,29,32,225,400,0,0
maksssksksss745.png,with_mask,146,228,223,328,77,100,400,301,0,0
maksssksksss746.png,with_mask,29,198,135,324,106,126,400,301,0,0
maksssksksss747.png,with_mask,94,198,189,327,95,129,400,301,0,0
maksssksksss748.png,mask_weared_incorrect,179,47,283,169,104,122,225,400,0,0
maksssksksss749.png,with_mask,93,102,118,126,25,24,400,251,0,0
maksssksksss749.png,with_mask,178,190,200,211,22,21,400,251,0,0
maksssksksss75.png,with_mask,42,38,53,50,11,12,211,400,0,0
maksssksksss75.png,with_mask,75,32,89,47,14,15,211,400,0,0
maksssksksss75.png,with_mask,97,37,118,55,21,18,211,400,0,0
maksssksksss75.png,with_mask,119,18,131,34,12,16,211,400,0,0
maksssksksss75.png,with_mask,202,35,218,54,16,19,211,400,0,0
maksssksksss75.png,with_mask,234,28,249,48,15,20,211,400,0,0
maksssksksss75.png,with_mask,276,26,298,50,22,24,211,400,0,0
maksssksksss75.png,with_mask,313,31,332,52,19,21,211,400,0,0
maksssksksss75.png,with_mask,351,27,366,41,15,14,211,400,0,0
maksssksksss75.png,without_mask,358,89,370,105,12,16,211,400,0,0
maksssksksss751.png,with_mask,95,116,135,145,40,29,267,400,0,0
maksssksksss751.png,with_mask,244,59,257,78,13,19,267,400,0,0
maksssksksss751.png,without_mask,249,26,284,57,35,31,267,400,0,0
maksssksksss751.png,with_mask,73,64,84,80,11,16,267,400,0,0
maksssksksss752.png,with_mask,55,15,66,29,11,14,225,400,0,0
maksssksksss752.png,with_mask,194,21,210,40,16,19,225,400,0,0
maksssksksss752.png,with_mask,271,20,287,37,16,17,225,400,0,0
maksssksksss752.png,with_mask,344,23,358,44,14,21,225,400,0,0
maksssksksss753.png,with_mask,198,136,238,177,40,41,267,400,0,0
maksssksksss754.png,with_mask,14,140,32,161,18,21,267,400,0,0
maksssksksss754.png,with_mask,113,113,131,137,18,24,267,400,0,0
maksssksksss754.png,with_mask,165,116,183,137,18,21,267,400,0,0
maksssksksss754.png,with_mask,206,89,228,114,22,25,267,400,0,0
maksssksksss755.png,with_mask,46,44,61,69,15,25,226,400,0,0
maksssksksss755.png,with_mask,36,98,47,121,11,23,226,400,0,0
maksssksksss755.png,with_mask,89,35,113,57,24,22,226,400,0,0
maksssksksss755.png,with_mask,127,25,147,49,20,24,226,400,0,0
maksssksksss755.png,with_mask,250,126,274,153,24,27,226,400,0,0
maksssksksss755.png,with_mask,248,71,269,96,21,25,226,400,0,0
maksssksksss755.png,with_mask,330,24,350,48,20,24,226,400,0,0
maksssksksss756.png,with_mask,216,40,251,82,35,42,267,400,0,0
maksssksksss756.png,mask_weared_incorrect,114,54,151,91,37,37,267,400,0,0
maksssksksss757.png,without_mask,104,182,220,317,116,135,400,301,0,0
maksssksksss758.png,with_mask,224,53,244,73,20,20,280,400,0,0
maksssksksss758.png,with_mask,318,48,338,72,20,24,280,400,0,0
maksssksksss758.png,with_mask,144,48,180,85,36,37,280,400,0,0
maksssksksss758.png,with_mask,66,68,83,85,17,17,280,400,0,0
maksssksksss758.png,with_mask,25,57,37,73,12,16,280,400,0,0
maksssksksss759.png,with_mask,91,80,140,140,49,60,267,400,0,0
maksssksksss759.png,with_mask,154,103,206,163,52,60,267,400,0,0
maksssksksss759.png,without_mask,273,87,339,146,66,59,267,400,0,0
maksssksksss76.png,with_mask,107,67,136,95,29,28,257,400,0,0
maksssksksss76.png,with_mask,286,70,300,84,14,14,257,400,0,0
maksssksksss76.png,with_mask,319,68,356,104,37,36,257,400,0,0
maksssksksss760.png,without_mask,89,26,113,56,24,30,225,400,0,0
maksssksksss760.png,mask_weared_incorrect,173,34,206,65,33,31,225,400,0,0
maksssksksss760.png,without_mask,98,96,138,127,40,31,225,400,0,0
maksssksksss760.png,mask_weared_incorrect,158,92,195,138,37,46,225,400,0,0
maksssksksss760.png,without_mask,217,103,252,141,35,38,225,400,0,0
maksssksksss760.png,without_mask,350,105,378,139,28,34,225,400,0,0
maksssksksss760.png,with_mask,211,160,236,201,25,41,225,400,0,0
maksssksksss761.png,mask_weared_incorrect,136,67,187,121,51,54,400,267,0,0
maksssksksss762.png,with_mask,156,167,259,304,103,137,400,301,0,0
maksssksksss763.png,with_mask,155,72,241,155,86,83,225,400,0,0
maksssksksss763.png,with_mask,309,36,369,104,60,68,225,400,0,0
maksssksksss764.png,with_mask,46,224,140,345,94,121,400,301,0,0
maksssksksss765.png,with_mask,56,196,156,314,100,118,400,301,0,0
maksssksksss766.png,with_mask,86,177,188,305,102,128,400,301,0,0
maksssksksss767.png,with_mask,116,36,144,71,28,35,400,267,0,0
maksssksksss768.png,with_mask,4,58,15,70,11,12,225,400,0,0
maksssksksss768.png,with_mask,49,21,67,40,18,19,225,400,0,0
maksssksksss768.png,with_mask,80,68,98,87,18,19,225,400,0,0
maksssksksss768.png,with_mask,127,57,139,71,12,14,225,400,0,0
maksssksksss768.png,with_mask,204,37,219,54,15,17,225,400,0,0
maksssksksss768.png,with_mask,227,113,243,129,16,16,225,400,0,0
maksssksksss769.png,with_mask,227,43,252,76,25,33,225,400,0,0
maksssksksss769.png,with_mask,281,132,308,156,27,24,225,400,0,0
maksssksksss77.png,with_mask,1,88,13,126,12,38,225,400,0,0
maksssksksss77.png,with_mask,57,97,88,134,31,37,225,400,0,0
maksssksksss77.png,with_mask,132,92,173,134,41,42,225,400,0,0
maksssksksss770.png,with_mask,80,39,97,64,17,25,210,400,0,0
maksssksksss770.png,with_mask,156,57,176,75,20,18,210,400,0,0
maksssksksss770.png,without_mask,215,38,227,53,12,15,210,400,0,0
maksssksksss770.png,without_mask,253,48,264,65,11,17,210,400,0,0
maksssksksss771.png,with_mask,31,109,93,161,62,52,267,400,0,0
maksssksksss771.png,with_mask,83,43,119,86,36,43,267,400,0,0
maksssksksss771.png,with_mask,140,70,195,128,55,58,267,400,0,0
maksssksksss771.png,with_mask,280,77,366,165,86,88,267,400,0,0
maksssksksss771.png,with_mask,360,10,394,46,34,36,267,400,0,0
maksssksksss772.png,without_mask,45,190,80,235,35,45,400,267,0,0
maksssksksss772.png,without_mask,108,150,169,212,61,62,400,267,0,0
maksssksksss773.png,with_mask,65,71,86,92,21,21,274,400,0,0
maksssksksss773.png,with_mask,148,60,175,88,27,28,274,400,0,0
maksssksksss773.png,with_mask,218,61,241,85,23,24,274,400,0,0
maksssksksss773.png,without_mask,290,63,312,83,22,20,274,400,0,0
maksssksksss773.png,without_mask,370,70,391,89,21,19,274,400,0,0
maksssksksss773.png,without_mask,380,18,393,30,13,12,274,400,0,0
maksssksksss774.png,with_mask,66,32,104,72,38,40,226,400,0,0
maksssksksss774.png,with_mask,122,80,173,138,51,58,226,400,0,0
maksssksksss774.png,with_mask,257,30,301,86,44,56,226,400,0,0
maksssksksss775.png,with_mask,77,66,130,108,53,42,225,400,0,0
maksssksksss775.png,with_mask,277,53,329,99,52,46,225,400,0,0
maksssksksss776.png,with_mask,15,79,42,105,27,26,267,400,0,0
maksssksksss776.png,with_mask,288,88,317,127,29,39,267,400,0,0
maksssksksss777.png,with_mask,49,146,102,201,53,55,226,400,0,0
maksssksksss777.png,with_mask,26,82,70,122,44,40,226,400,0,0
maksssksksss777.png,with_mask,73,48,102,78,29,30,226,400,0,0
maksssksksss777.png,with_mask,137,42,163,74,26,32,226,400,0,0
maksssksksss777.png,with_mask,187,52,220,86,33,34,226,400,0,0
maksssksksss777.png,without_mask,226,47,248,70,22,23,226,400,0,0
maksssksksss777.png,with_mask,285,35,322,71,37,36,226,400,0,0
maksssksksss777.png,with_mask,363,32,397,72,34,40,226,400,0,0
maksssksksss778.png,with_mask,57,21,88,59,31,38,267,400,0,0
maksssksksss778.png,with_mask,84,108,123,147,39,39,267,400,0,0
maksssksksss778.png,with_mask,176,53,202,81,26,28,267,400,0,0
maksssksksss778.png,with_mask,223,36,252,70,29,34,267,400,0,0
maksssksksss778.png,with_mask,315,87,379,146,64,59,267,400,0,0
maksssksksss779.png,with_mask,23,43,59,82,36,39,266,400,0,0
maksssksksss779.png,with_mask,77,20,112,61,35,41,266,400,0,0
maksssksksss779.png,with_mask,139,41,163,71,24,30,266,400,0,0
maksssksksss779.png,with_mask,189,71,212,98,23,27,266,400,0,0
maksssksksss779.png,with_mask,323,77,335,97,12,20,266,400,0,0
maksssksksss78.png,with_mask,108,231,186,336,78,105,400,301,0,0
maksssksksss780.png,with_mask,344,67,365,84,21,17,225,400,0,0
maksssksksss780.png,with_mask,231,128,301,179,70,51,225,400,0,0
maksssksksss780.png,with_mask,95,60,151,130,56,70,225,400,0,0
maksssksksss780.png,with_mask,176,77,224,110,48,33,225,400,0,0
maksssksksss780.png,with_mask,158,61,176,84,18,23,225,400,0,0
maksssksksss781.png,with_mask,78,199,191,333,113,134,400,301,0,0
maksssksksss782.png,mask_weared_incorrect,202,145,228,174,26,29,226,400,0,0
maksssksksss782.png,with_mask,289,86,327,127,38,41,226,400,0,0
maksssksksss783.png,with_mask,136,59,153,76,17,17,267,400,0,0
maksssksksss783.png,with_mask,194,132,210,148,16,16,267,400,0,0
maksssksksss783.png,with_mask,243,136,258,150,15,14,267,400,0,0
maksssksksss783.png,with_mask,241,32,261,54,20,22,267,400,0,0
maksssksksss783.png,with_mask,330,23,353,52,23,29,267,400,0,0
maksssksksss784.png,without_mask,17,59,39,82,22,23,225,400,0,0
maksssksksss784.png,with_mask,43,59,71,92,28,33,225,400,0,0
maksssksksss784.png,with_mask,91,78,120,108,29,30,225,400,0,0
maksssksksss784.png,with_mask,110,43,141,77,31,34,225,400,0,0
maksssksksss784.png,with_mask,138,82,169,112,31,30,225,400,0,0
maksssksksss784.png,with_mask,175,55,204,88,29,33,225,400,0,0
maksssksksss784.png,with_mask,235,36,267,71,32,35,225,400,0,0
maksssksksss784.png,with_mask,276,67,306,99,30,32,225,400,0,0
maksssksksss784.png,with_mask,317,69,343,105,26,36,225,400,0,0
maksssksksss785.png,without_mask,159,90,217,164,58,74,244,400,0,0
maksssksksss786.png,with_mask,38,222,67,247,29,25,290,400,0,0
maksssksksss786.png,with_mask,91,250,131,270,40,20,290,400,0,0
maksssksksss786.png,with_mask,177,71,221,107,44,36,290,400,0,0
maksssksksss786.png,mask_weared_incorrect,244,64,297,122,53,58,290,400,0,0
maksssksksss787.png,without_mask,59,50,111,100,52,50,288,400,0,0
maksssksksss787.png,with_mask,23,118,76,179,53,61,288,400,0,0
maksssksksss787.png,with_mask,92,109,136,164,44,55,288,400,0,0
maksssksksss787.png,with_mask,147,111,202,170,55,59,288,400,0,0
maksssksksss787.png,without_mask,188,60,233,97,45,37,288,400,0,0
maksssksksss787.png,with_mask,247,84,285,132,38,48,288,400,0,0
maksssksksss787.png,with_mask,292,99,352,162,60,63,288,400,0,0
maksssksksss788.png,with_mask,14,95,45,131,31,36,340,512,0,0
maksssksksss788.png,with_mask,116,93,147,126,31,33,340,512,0,0
maksssksksss788.png,with_mask,210,105,241,137,31,32,340,512,0,0
maksssksksss788.png,with_mask,307,92,332,123,25,31,340,512,0,0
maksssksksss788.png,with_mask,388,87,418,121,30,34,340,512,0,0
maksssksksss789.png,with_mask,32,24,59,54,27,30,255,400,0,0
maksssksksss789.png,with_mask,161,40,179,53,18,13,255,400,0,0
maksssksksss789.png,with_mask,272,53,288,70,16,17,255,400,0,0
maksssksksss789.png,with_mask,290,40,304,58,14,18,255,400,0,0
maksssksksss79.png,with_mask,60,121,87,148,27,27,400,400,0,0
maksssksksss79.png,with_mask,183,117,208,146,25,29,400,400,0,0
maksssksksss79.png,with_mask,239,165,256,183,17,18,400,400,0,0
maksssksksss79.png,with_mask,282,149,300,169,18,20,400,400,0,0
maksssksksss79.png,with_mask,330,100,356,128,26,28,400,400,0,0
maksssksksss790.png,with_mask,124,159,226,288,102,129,400,301,0,0
maksssksksss791.png,with_mask,124,121,213,264,89,143,400,301,0,0
maksssksksss792.png,with_mask,153,53,196,107,43,54,225,400,0,0
maksssksksss792.png,without_mask,196,36,239,81,43,45,225,400,0,0
maksssksksss792.png,without_mask,16,148,42,199,26,51,225,400,0,0
maksssksksss792.png,without_mask,26,43,60,89,34,46,225,400,0,0
maksssksksss792.png,without_mask,324,73,353,112,29,39,225,400,0,0
maksssksksss792.png,without_mask,354,66,400,108,46,42,225,400,0,0
maksssksksss793.png,with_mask,134,147,241,275,107,128,400,301,0,0
maksssksksss794.png,with_mask,65,179,137,263,72,84,400,400,0,0
maksssksksss794.png,with_mask,254,189,332,276,78,87,400,400,0,0
maksssksksss795.png,without_mask,8,1,31,23,23,22,300,400,0,0
maksssksksss795.png,with_mask,9,91,31,119,22,28,300,400,0,0
maksssksksss795.png,with_mask,86,68,110,92,24,24,300,400,0,0
maksssksksss795.png,with_mask,101,7,126,34,25,27,300,400,0,0
maksssksksss795.png,without_mask,15,129,35,155,20,26,300,400,0,0
maksssksksss795.png,with_mask,1,245,18,284,17,39,300,400,0,0
maksssksksss795.png,with_mask,25,218,53,253,28,35,300,400,0,0
maksssksksss795.png,mask_weared_incorrect,47,198,69,231,22,33,300,400,0,0
maksssksksss795.png,with_mask,89,133,111,161,22,28,300,400,0,0
maksssksksss795.png,with_mask,185,30,210,53,25,23,300,400,0,0
maksssksksss795.png,with_mask,181,67,208,95,27,28,300,400,0,0
maksssksksss795.png,with_mask,189,113,214,141,25,28,300,400,0,0
maksssksksss795.png,with_mask,133,261,161,294,28,33,300,400,0,0
maksssksksss795.png,with_mask,195,211,224,239,29,28,300,400,0,0
maksssksksss795.png,with_mask,216,231,246,264,30,33,300,400,0,0
maksssksksss795.png,with_mask,254,133,276,159,22,26,300,400,0,0
maksssksksss795.png,with_mask,261,66,286,93,25,27,300,400,0,0
maksssksksss795.png,with_mask,299,63,323,93,24,30,300,400,0,0
maksssksksss795.png,with_mask,334,14,352,36,18,22,300,400,0,0
maksssksksss795.png,with_mask,362,90,389,115,27,25,300,400,0,0
maksssksksss795.png,with_mask,375,179,400,205,25,26,300,400,0,0
maksssksksss796.png,with_mask,6,74,30,97,24,23,267,400,0,0
maksssksksss796.png,with_mask,8,113,34,136,26,23,267,400,0,0
maksssksksss796.png,with_mask,46,80,80,121,34,41,267,400,0,0
maksssksksss796.png,with_mask,90,95,110,117,20,22,267,400,0,0
maksssksksss796.png,with_mask,189,33,218,65,29,32,267,400,0,0
maksssksksss796.png,with_mask,310,65,352,110,42,45,267,400,0,0
maksssksksss796.png,with_mask,355,110,374,132,19,22,267,400,0,0
maksssksksss796.png,with_mask,272,112,293,129,21,17,267,400,0,0
maksssksksss796.png,with_mask,298,109,312,124,14,15,267,400,0,0
maksssksksss796.png,with_mask,92,72,112,91,20,19,267,400,0,0
maksssksksss796.png,with_mask,365,92,380,107,15,15,267,400,0,0
maksssksksss796.png,with_mask,373,120,385,137,12,17,267,400,0,0
maksssksksss796.png,with_mask,217,56,230,80,13,24,267,400,0,0
maksssksksss797.png,with_mask,13,84,27,106,14,22,245,400,0,0
maksssksksss797.png,with_mask,44,57,60,77,16,20,245,400,0,0
maksssksksss797.png,with_mask,76,80,90,93,14,13,245,400,0,0
maksssksksss797.png,with_mask,122,69,137,87,15,18,245,400,0,0
maksssksksss797.png,with_mask,190,73,206,91,16,18,245,400,0,0
maksssksksss797.png,with_mask,228,82,241,100,13,18,245,400,0,0
maksssksksss797.png,with_mask,281,67,295,85,14,18,245,400,0,0
maksssksksss797.png,without_mask,368,61,390,97,22,36,245,400,0,0
maksssksksss798.png,with_mask,185,62,272,130,87,68,333,400,0,0
maksssksksss798.png,with_mask,164,238,262,322,98,84,333,400,0,0
maksssksksss799.png,with_mask,29,66,47,82,18,16,300,400,0,0
maksssksksss799.png,with_mask,45,41,65,63,20,22,300,400,0,0
maksssksksss799.png,with_mask,11,217,65,263,54,46,300,400,0,0
maksssksksss799.png,with_mask,84,239,134,285,50,46,300,400,0,0
maksssksksss799.png,with_mask,304,210,325,230,21,20,300,400,0,0
maksssksksss799.png,with_mask,317,249,333,266,16,17,300,400,0,0
maksssksksss799.png,with_mask,340,251,369,275,29,24,300,400,0,0
maksssksksss8.png,with_mask,75,271,152,385,77,114,400,301,0,0
maksssksksss80.png,with_mask,214,54,291,132,77,78,226,400,0,0
maksssksksss800.png,with_mask,62,71,76,85,14,14,267,400,0,0
maksssksksss800.png,with_mask,184,76,198,92,14,16,267,400,0,0
maksssksksss800.png,with_mask,248,61,265,79,17,18,267,400,0,0
maksssksksss800.png,with_mask,317,65,334,81,17,16,267,400,0,0
maksssksksss801.png,with_mask,73,92,92,118,19,26,295,400,0,0
maksssksksss801.png,with_mask,158,112,181,130,23,18,295,400,0,0
maksssksksss801.png,without_mask,221,90,236,108,15,18,295,400,0,0
maksssksksss801.png,without_mask,263,100,279,120,16,20,295,400,0,0
maksssksksss802.png,with_mask,36,9,60,29,24,20,267,400,0,0
maksssksksss802.png,with_mask,133,35,153,56,20,21,267,400,0,0
maksssksksss802.png,with_mask,180,71,202,94,22,23,267,400,0,0
maksssksksss802.png,with_mask,312,76,344,109,32,33,267,400,0,0
maksssksksss803.png,with_mask,161,170,227,248,66,78,267,400,0,0
maksssksksss804.png,with_mask,72,31,94,51,22,20,258,400,0,0
maksssksksss804.png,with_mask,107,91,125,108,18,17,258,400,0,0
maksssksksss804.png,with_mask,177,45,196,63,19,18,258,400,0,0
maksssksksss804.png,with_mask,357,43,374,60,17,17,258,400,0,0
maksssksksss804.png,with_mask,269,50,284,64,15,14,258,400,0,0
maksssksksss804.png,with_mask,237,46,251,58,14,12,258,400,0,0
maksssksksss804.png,with_mask,221,54,232,66,11,12,258,400,0,0
maksssksksss805.png,with_mask,38,3,90,55,52,52,225,400,0,0
maksssksksss805.png,with_mask,173,7,225,58,52,51,225,400,0,0
maksssksksss805.png,with_mask,307,7,351,53,44,46,225,400,0,0
maksssksksss805.png,with_mask,285,97,335,151,50,54,225,400,0,0
maksssksksss805.png,with_mask,175,101,225,148,50,47,225,400,0,0
maksssksksss805.png,with_mask,46,90,93,146,47,56,225,400,0,0
maksssksksss805.png,with_mask,49,195,93,225,44,30,225,400,0,0
maksssksksss805.png,with_mask,178,193,218,225,40,32,225,400,0,0
maksssksksss805.png,with_mask,305,196,362,225,57,29,225,400,0,0
maksssksksss806.png,with_mask,29,34,62,68,33,34,225,400,0,0
maksssksksss806.png,with_mask,95,53,126,91,31,38,225,400,0,0
maksssksksss806.png,with_mask,151,62,177,94,26,32,225,400,0,0
maksssksksss806.png,with_mask,188,65,221,103,33,38,225,400,0,0
maksssksksss806.png,with_mask,288,21,322,65,34,44,225,400,0,0
maksssksksss806.png,with_mask,249,65,272,88,23,23,225,400,0,0
maksssksksss807.png,with_mask,19,47,35,61,16,14,267,400,0,0
maksssksksss807.png,with_mask,58,42,73,57,15,15,267,400,0,0
maksssksksss807.png,with_mask,108,56,125,69,17,13,267,400,0,0
maksssksksss807.png,with_mask,165,28,184,49,19,21,267,400,0,0
maksssksksss807.png,with_mask,212,34,230,58,18,24,267,400,0,0
maksssksksss807.png,mask_weared_incorrect,248,59,259,70,11,11,267,400,0,0
maksssksksss807.png,with_mask,274,37,296,62,22,25,267,400,0,0
maksssksksss807.png,with_mask,370,22,394,44,24,22,267,400,0,0
maksssksksss808.png,with_mask,109,134,206,253,97,119,400,301,0,0
maksssksksss809.png,without_mask,21,78,65,119,44,41,352,400,0,0
maksssksksss809.png,with_mask,134,77,188,128,54,51,352,400,0,0
maksssksksss809.png,with_mask,290,43,335,93,45,50,352,400,0,0
maksssksksss81.png,with_mask,27,46,123,154,96,108,240,400,0,0
maksssksksss81.png,with_mask,145,99,229,190,84,91,240,400,0,0
maksssksksss81.png,with_mask,275,82,362,174,87,92,240,400,0,0
maksssksksss810.png,with_mask,107,277,216,400,109,123,400,301,0,0
maksssksksss811.png,with_mask,56,47,223,238,167,191,400,267,0,0
maksssksksss812.png,with_mask,291,54,352,113,61,59,400,400,0,0
maksssksksss812.png,with_mask,165,115,213,165,48,50,400,400,0,0
maksssksksss812.png,with_mask,66,91,115,136,49,45,400,400,0,0
maksssksksss813.png,with_mask,99,100,340,382,241,282,492,381,0,0
maksssksksss814.png,with_mask,114,262,207,379,93,117,400,301,0,0
maksssksksss815.png,mask_weared_incorrect,117,77,179,117,62,40,400,267,0,0
maksssksksss816.png,with_mask,335,4,359,33,24,29,268,400,0,0
maksssksksss816.png,with_mask,294,61,326,85,32,24,268,400,0,0
maksssksksss816.png,with_mask,233,24,279,70,46,46,268,400,0,0
maksssksksss816.png,with_mask,227,101,270,143,43,42,268,400,0,0
maksssksksss816.png,with_mask,152,184,196,230,44,46,268,400,0,0
maksssksksss817.png,without_mask,102,141,193,250,91,109,400,301,0,0
maksssksksss818.png,without_mask,122,226,233,374,111,148,400,301,0,0
maksssksksss819.png,with_mask,68,63,129,128,61,65,225,400,0,0
maksssksksss82.png,with_mask,7,53,27,75,20,22,225,400,0,0
maksssksksss82.png,with_mask,57,67,79,89,22,22,225,400,0,0
maksssksksss82.png,with_mask,149,45,172,72,23,27,225,400,0,0
maksssksksss82.png,with_mask,192,36,215,65,23,29,225,400,0,0
maksssksksss82.png,with_mask,241,74,262,97,21,23,225,400,0,0
maksssksksss82.png,with_mask,331,58,354,88,23,30,225,400,0,0
maksssksksss820.png,with_mask,178,58,247,142,69,84,225,400,0,0
maksssksksss821.png,with_mask,176,94,224,149,48,55,267,400,0,0
maksssksksss821.png,without_mask,371,108,400,144,29,36,267,400,0,0
maksssksksss822.png,with_mask,7,59,20,78,13,19,225,400,0,0
maksssksksss822.png,with_mask,36,53,55,73,19,20,225,400,0,0
maksssksksss822.png,with_mask,97,133,111,147,14,14,225,400,0,0
maksssksksss822.png,with_mask,115,90,130,108,15,18,225,400,0,0
maksssksksss822.png,with_mask,133,75,147,89,14,14,225,400,0,0
maksssksksss822.png,with_mask,159,85,176,100,17,15,225,400,0,0
maksssksksss822.png,with_mask,180,86,193,98,13,12,225,400,0,0
maksssksksss822.png,with_mask,222,78,235,93,13,15,225,400,0,0
maksssksksss822.png,with_mask,248,81,262,96,14,15,225,400,0,0
maksssksksss822.png,with_mask,282,68,296,82,14,14,225,400,0,0
maksssksksss822.png,without_mask,81,68,96,85,15,17,225,400,0,0
maksssksksss822.png,without_mask,120,74,131,85,11,11,225,400,0,0
maksssksksss822.png,without_mask,207,80,219,96,12,16,225,400,0,0
maksssksksss822.png,without_mask,151,76,165,91,14,15,225,400,0,0
maksssksksss823.png,with_mask,183,5,266,92,83,87,210,400,0,0
maksssksksss823.png,with_mask,341,114,381,164,40,50,210,400,0,0
maksssksksss823.png,with_mask,353,86,379,147,26,61,210,400,0,0
maksssksksss823.png,without_mask,42,71,70,133,28,62,210,400,0,0
maksssksksss824.png,mask_weared_incorrect,29,127,50,157,21,30,267,400,0,0
maksssksksss824.png,with_mask,103,125,121,146,18,21,267,400,0,0
maksssksksss824.png,with_mask,170,134,189,156,19,22,267,400,0,0
maksssksksss824.png,without_mask,231,162,249,178,18,16,267,400,0,0
maksssksksss824.png,with_mask,261,125,281,145,20,20,267,400,0,0
maksssksksss824.png,with_mask,298,125,309,138,11,13,267,400,0,0
maksssksksss825.png,with_mask,45,33,85,68,40,35,225,400,0,0
maksssksksss825.png,with_mask,135,20,169,52,34,32,225,400,0,0
maksssksksss825.png,with_mask,227,32,254,61,27,29,225,400,0,0
maksssksksss825.png,with_mask,300,30,330,58,30,28,225,400,0,0
maksssksksss826.png,with_mask,94,87,122,121,28,34,267,400,0,0
maksssksksss826.png,with_mask,19,65,41,92,22,27,267,400,0,0
maksssksksss826.png,with_mask,190,84,207,105,17,21,267,400,0,0
maksssksksss826.png,with_mask,244,80,257,99,13,19,267,400,0,0
maksssksksss826.png,with_mask,336,78,397,122,61,44,267,400,0,0
maksssksksss827.png,with_mask,48,144,177,307,129,163,400,301,0,0
maksssksksss828.png,with_mask,65,174,180,323,115,149,400,301,0,0
maksssksksss829.png,with_mask,8,62,47,95,39,33,200,400,0,0
maksssksksss829.png,with_mask,123,45,138,59,15,14,200,400,0,0
maksssksksss829.png,with_mask,162,50,174,65,12,15,200,400,0,0
maksssksksss829.png,with_mask,245,45,260,60,15,15,200,400,0,0
maksssksksss829.png,with_mask,268,26,285,45,17,19,200,400,0,0
maksssksksss829.png,with_mask,342,33,374,73,32,40,200,400,0,0
maksssksksss829.png,with_mask,277,85,294,102,17,17,200,400,0,0
maksssksksss829.png,without_mask,320,49,342,67,22,18,200,400,0,0
maksssksksss829.png,without_mask,75,30,89,48,14,18,200,400,0,0
maksssksksss829.png,with_mask,214,29,228,43,14,14,200,400,0,0
maksssksksss83.png,with_mask,37,60,112,137,75,77,306,400,0,0
maksssksksss83.png,with_mask,145,116,229,209,84,93,306,400,0,0
maksssksksss83.png,without_mask,268,16,380,135,112,119,306,400,0,0
maksssksksss830.png,mask_weared_incorrect,167,77,220,133,53,56,400,267,0,0
maksssksksss831.png,with_mask,74,62,120,112,46,50,241,400,0,0
maksssksksss832.png,mask_weared_incorrect,90,80,212,247,122,167,400,309,0,0
maksssksksss833.png,with_mask,150,56,223,136,73,80,226,400,0,0
maksssksksss834.png,with_mask,33,25,66,65,33,40,267,400,0,0
maksssksksss834.png,with_mask,171,74,189,91,18,17,267,400,0,0
maksssksksss834.png,with_mask,221,48,241,76,20,28,267,400,0,0
maksssksksss834.png,with_mask,263,111,282,127,19,16,267,400,0,0
maksssksksss834.png,with_mask,337,136,361,161,24,25,267,400,0,0
maksssksksss835.png,mask_weared_incorrect,57,86,162,184,105,98,400,267,0,0
maksssksksss836.png,with_mask,241,88,277,122,36,34,313,400,0,0
maksssksksss836.png,with_mask,150,186,179,218,29,32,313,400,0,0
maksssksksss836.png,with_mask,100,158,125,185,25,27,313,400,0,0
maksssksksss836.png,with_mask,201,68,231,102,30,34,313,400,0,0
maksssksksss836.png,with_mask,114,79,143,113,29,34,313,400,0,0
maksssksksss837.png,without_mask,95,151,192,261,97,110,400,301,0,0
maksssksksss838.png,with_mask,142,161,253,324,111,163,400,301,0,0
maksssksksss839.png,with_mask,50,81,68,99,18,18,261,400,0,0
maksssksksss839.png,with_mask,96,47,109,63,13,16,261,400,0,0
maksssksksss839.png,with_mask,212,56,230,77,18,21,261,400,0,0
maksssksksss839.png,with_mask,354,42,372,67,18,25,261,400,0,0
maksssksksss84.png,with_mask,64,129,110,174,46,45,354,512,0,0
maksssksksss84.png,with_mask,166,136,222,196,56,60,354,512,0,0
maksssksksss84.png,with_mask,383,126,430,184,47,58,354,512,0,0
maksssksksss840.png,with_mask,167,50,196,83,29,33,267,400,0,0
maksssksksss840.png,with_mask,223,83,245,111,22,28,267,400,0,0
maksssksksss841.png,without_mask,134,184,223,296,89,112,400,301,0,0
maksssksksss842.png,without_mask,82,95,102,126,20,31,225,400,0,0
maksssksksss842.png,with_mask,147,98,189,139,42,41,225,400,0,0
maksssksksss842.png,with_mask,213,98,260,145,47,47,225,400,0,0
maksssksksss842.png,with_mask,328,62,367,104,39,42,225,400,0,0
maksssksksss843.png,with_mask,1,132,59,215,58,83,400,400,0,0
maksssksksss843.png,with_mask,139,128,224,210,85,82,400,400,0,0
maksssksksss843.png,with_mask,331,205,400,277,69,72,400,400,0,0
maksssksksss844.png,with_mask,157,39,197,82,40,43,225,400,0,0
maksssksksss844.png,with_mask,277,24,305,56,28,32,225,400,0,0
maksssksksss845.png,with_mask,101,197,180,306,79,109,400,301,0,0
maksssksksss846.png,with_mask,158,43,191,85,33,42,226,400,0,0
maksssksksss847.png,with_mask,3,205,32,225,29,20,226,400,0,0
maksssksksss847.png,with_mask,35,178,63,208,28,30,226,400,0,0
maksssksksss847.png,mask_weared_incorrect,56,160,78,187,22,27,226,400,0,0
maksssksksss847.png,without_mask,28,98,48,119,20,21,226,400,0,0
maksssksksss847.png,with_mask,96,101,116,126,20,25,226,400,0,0
maksssksksss847.png,with_mask,93,40,116,61,23,21,226,400,0,0
maksssksksss847.png,with_mask,25,62,43,86,18,24,226,400,0,0
maksssksksss847.png,with_mask,3,54,16,74,13,20,226,400,0,0
maksssksksss847.png,with_mask,211,190,240,219,29,29,226,400,0,0
maksssksksss847.png,with_mask,195,172,221,194,26,22,226,400,0,0
maksssksksss847.png,with_mask,188,82,212,106,24,24,226,400,0,0
maksssksksss847.png,with_mask,181,40,206,61,25,21,226,400,0,0
maksssksksss847.png,with_mask,184,7,207,24,23,17,226,400,0,0
maksssksksss847.png,with_mask,254,38,276,63,22,25,226,400,0,0
maksssksksss847.png,with_mask,246,99,268,122,22,23,226,400,0,0
maksssksksss847.png,with_mask,288,37,312,63,24,26,226,400,0,0
maksssksksss847.png,with_mask,318,22,341,42,23,20,226,400,0,0
maksssksksss847.png,with_mask,345,61,372,84,27,23,226,400,0,0
maksssksksss847.png,with_mask,361,143,387,166,26,23,226,400,0,0
maksssksksss848.png,with_mask,141,58,159,78,18,20,268,400,0,0
maksssksksss848.png,with_mask,186,73,201,88,15,15,268,400,0,0
maksssksksss848.png,with_mask,348,8,377,54,29,46,268,400,0,0
maksssksksss849.png,with_mask,48,52,67,70,19,18,236,400,0,0
maksssksksss849.png,with_mask,95,20,109,36,14,16,236,400,0,0
maksssksksss849.png,with_mask,213,29,231,50,18,21,236,400,0,0
maksssksksss849.png,with_mask,354,15,375,41,21,26,236,400,0,0
maksssksksss85.png,with_mask,84,54,199,167,115,113,400,267,0,0
maksssksksss850.png,with_mask,46,52,64,81,18,29,200,400,0,0
maksssksksss850.png,with_mask,146,30,176,60,30,30,200,400,0,0
maksssksksss850.png,with_mask,323,47,351,78,28,31,200,400,0,0
maksssksksss851.png,with_mask,66,205,156,330,90,125,400,301,0,0
maksssksksss852.png,with_mask,139,94,198,147,59,53,400,267,0,0
maksssksksss852.png,without_mask,92,86,132,125,40,39,400,267,0,0
maksssksksss86.png,with_mask,22,121,77,181,55,60,300,400,0,0
maksssksksss86.png,with_mask,231,76,290,144,59,68,300,400,0,0
maksssksksss86.png,without_mask,335,135,395,198,60,63,300,400,0,0
maksssksksss86.png,without_mask,78,105,111,149,33,44,300,400,0,0
maksssksksss87.png,with_mask,129,284,211,387,82,103,400,301,0,0
maksssksksss88.png,with_mask,42,176,151,304,109,128,400,301,0,0
maksssksksss89.png,with_mask,47,112,61,127,14,15,217,400,0,0
maksssksksss89.png,with_mask,62,102,85,128,23,26,217,400,0,0
maksssksksss89.png,with_mask,86,102,99,117,13,15,217,400,0,0
maksssksksss89.png,with_mask,117,136,141,159,24,23,217,400,0,0
maksssksksss89.png,with_mask,163,135,175,146,12,11,217,400,0,0
maksssksksss89.png,with_mask,209,102,222,116,13,14,217,400,0,0
maksssksksss89.png,with_mask,202,121,219,150,17,29,217,400,0,0
maksssksksss89.png,with_mask,249,103,266,117,17,14,217,400,0,0
maksssksksss89.png,with_mask,286,124,338,178,52,54,217,400,0,0
maksssksksss89.png,with_mask,377,81,393,101,16,20,217,400,0,0
maksssksksss9.png,mask_weared_incorrect,148,75,201,133,53,58,400,267,0,0
maksssksksss9.png,without_mask,27,78,56,106,29,28,400,267,0,0
maksssksksss90.png,with_mask,47,61,81,103,34,42,267,400,0,0
maksssksksss90.png,with_mask,102,83,133,125,31,42,267,400,0,0
maksssksksss90.png,with_mask,181,54,208,86,27,32,267,400,0,0
maksssksksss90.png,with_mask,214,51,252,96,38,45,267,400,0,0
maksssksksss90.png,with_mask,199,126,239,174,40,48,267,400,0,0
maksssksksss90.png,with_mask,245,19,273,46,28,27,267,400,0,0
maksssksksss90.png,with_mask,311,37,339,72,28,35,267,400,0,0
maksssksksss90.png,with_mask,272,33,292,55,20,22,267,400,0,0
maksssksksss91.png,with_mask,62,11,96,52,34,41,225,400,0,0
maksssksksss91.png,with_mask,111,48,169,115,58,67,225,400,0,0
maksssksksss91.png,with_mask,200,1,248,43,48,42,225,400,0,0
maksssksksss91.png,with_mask,244,65,305,141,61,76,225,400,0,0
maksssksksss91.png,with_mask,290,101,342,185,52,84,225,400,0,0
maksssksksss92.png,with_mask,12,141,39,174,27,33,267,400,0,0
maksssksksss92.png,with_mask,116,115,148,151,32,36,267,400,0,0
maksssksksss92.png,with_mask,179,79,249,149,70,70,267,400,0,0
maksssksksss92.png,with_mask,323,95,359,143,36,48,267,400,0,0
maksssksksss92.png,with_mask,87,123,108,147,21,24,267,400,0,0
maksssksksss92.png,without_mask,16,115,38,139,22,24,267,400,0,0
maksssksksss92.png,with_mask,249,122,264,141,15,19,267,400,0,0
maksssksksss92.png,with_mask,356,117,370,143,14,26,267,400,0,0
maksssksksss93.png,with_mask,82,72,104,92,22,20,267,400,0,0
maksssksksss93.png,with_mask,150,78,165,94,15,16,267,400,0,0
maksssksksss93.png,with_mask,171,78,195,103,24,25,267,400,0,0
maksssksksss93.png,with_mask,181,101,207,129,26,28,267,400,0,0
maksssksksss93.png,with_mask,219,82,234,97,15,15,267,400,0,0
maksssksksss93.png,with_mask,248,76,267,95,19,19,267,400,0,0
maksssksksss93.png,with_mask,271,77,297,103,26,26,267,400,0,0
maksssksksss93.png,with_mask,292,62,309,82,17,20,267,400,0,0
maksssksksss94.png,with_mask,374,66,400,98,26,32,226,400,0,0
maksssksksss94.png,with_mask,305,58,337,93,32,35,226,400,0,0
maksssksksss94.png,with_mask,43,77,83,127,40,50,226,400,0,0
maksssksksss94.png,with_mask,110,95,171,169,61,74,226,400,0,0
maksssksksss94.png,mask_weared_incorrect,227,91,255,122,28,31,226,400,0,0
maksssksksss94.png,without_mask,267,74,290,96,23,22,226,400,0,0
maksssksksss95.png,without_mask,67,289,155,400,88,111,400,301,0,0
maksssksksss96.png,with_mask,102,97,140,135,38,38,280,400,0,0
maksssksksss96.png,without_mask,64,151,110,201,46,50,280,400,0,0
maksssksksss96.png,without_mask,251,88,282,124,31,36,280,400,0,0
maksssksksss96.png,with_mask,296,153,335,195,39,42,280,400,0,0
maksssksksss97.png,with_mask,187,83,212,109,25,26,400,301,0,0
maksssksksss98.png,with_mask,196,43,236,91,40,48,267,400,0,0
maksssksksss98.png,with_mask,41,73,65,95,24,22,267,400,0,0
maksssksksss98.png,with_mask,263,62,287,85,24,23,267,400,0,0
maksssksksss98.png,with_mask,344,80,377,106,33,26,267,400,0,0
maksssksksss99.png,mask_weared_incorrect,181,54,273,162,92,108,267,400,0,0
maksssksksss99.png,with_mask,99,87,176,165,77,78,267,400,0,0
maksssksksss99.png,with_mask,289,99,355,233,66,134,267,400,0,0
